SOURCELONG:Player's Handbook 2	SOURCESHORT:PHB2	SOURCEWEB:http://www.gozzilioni.net
		
#Teleport	CLASSES:Sorcerer,Wizard=5	TYPE:Arcane.Divine
Dancing Lights.MOD	CLASSES:Beguiler=0	TYPE:Arcane
Daze.MOD	CLASSES:Beguiler=0	TYPE:Arcane
Detect Magic.MOD	CLASSES:Beguiler=0	TYPE:Arcane
Ghost Sound.MOD	CLASSES:Beguiler=0	TYPE:Arcane
Message.MOD	CLASSES:Beguiler=0	TYPE:Arcane
Open/Close.MOD	CLASSES:Beguiler=0	TYPE:Arcane
Read Magic.MOD	CLASSES:Beguiler=0	TYPE:Arcane
Charm Person.MOD	CLASSES:Beguiler=1	TYPE:Arcane
Color Spray.MOD	CLASSES:Beguiler=1	TYPE:Arcane
Comprehend Languages.MOD	CLASSES:Beguiler=1	TYPE:Arcane
Detect Secret Doors.MOD	CLASSES:Beguiler=1	TYPE:Arcane
Disguise Self.MOD	CLASSES:Beguiler=1	TYPE:Arcane
Expeditious Retreat.MOD	CLASSES:Beguiler=1	TYPE:Arcane
Hypnotism.MOD	CLASSES:Beguiler=1	TYPE:Arcane
Mage Armor.MOD	CLASSES:Beguiler=1	TYPE:Arcane
Obscuring Mist.MOD	CLASSES:Beguiler=1	TYPE:Arcane
Rouse.MOD	CLASSES:Beguiler=1	TYPE:Arcane
Silent Image.MOD	CLASSES:Beguiler=1	TYPE:Arcane
Sleep.MOD	CLASSES:Beguiler=1	TYPE:Arcane
Undetectable Alignment.MOD	CLASSES:Beguiler=1	TYPE:Arcane
Whelm.MOD	CLASSES:Beguiler=1	TYPE:Arcane
Blinding Color Surge.MOD	CLASSES:Beguiler=2	TYPE:Arcane
Blur.MOD	CLASSES:Beguiler=2	TYPE:Arcane
Daze Monster.MOD	CLASSES:Beguiler=2	TYPE:Arcane
Detect Thoughts.MOD	CLASSES:Beguiler=2	TYPE:Arcane
Fog Cloud.MOD	CLASSES:Beguiler=2	TYPE:Arcane
Glitterdust.MOD	CLASSES:Beguiler=2	TYPE:Arcane
Hypnotic Pattern.MOD	CLASSES:Beguiler=2	TYPE:Arcane
Invisibility.MOD	CLASSES:Beguiler=2	TYPE:Arcane
Knock.MOD	CLASSES:Beguiler=2	TYPE:Arcane
Minor Image.MOD	CLASSES:Beguiler=2	TYPE:Arcane
Mirror Image.MOD	CLASSES:Beguiler=2	TYPE:Arcane
Misdirection.MOD	CLASSES:Beguiler=2	TYPE:Arcane
See Invisibility.MOD	CLASSES:Beguiler=2	TYPE:Arcane
Silence.MOD	CLASSES:Beguiler=2	TYPE:Arcane
Spider Climb.MOD	CLASSES:Beguiler=2	TYPE:Arcane
Stay the Hand.MOD	CLASSES:Beguiler=2	TYPE:Arcane
Touch of Idiocy.MOD	CLASSES:Beguiler=2	TYPE:Arcane
Vertigo.MOD	CLASSES:Beguiler=2	TYPE:Arcane
Whelming Blast.MOD	CLASSES:Beguiler=2	TYPE:Arcane
Arcane Sight.MOD	CLASSES:Beguiler=3	TYPE:Arcane
Clairaudience/Clairvoyance.MOD	CLASSES:Beguiler=3	TYPE:Arcane
Crown of Veils.MOD	CLASSES:Beguiler=3	TYPE:Arcane
Deep Slumber.MOD	CLASSES:Beguiler=3	TYPE:Arcane
Dispel Magic.MOD	CLASSES:Beguiler=3	TYPE:Arcane
Displacement.MOD	CLASSES:Beguiler=3	TYPE:Arcane
Glibness.MOD	CLASSES:Beguiler=3	TYPE:Arcane
Halt.MOD	CLASSES:Beguiler=3	TYPE:Arcane
Haste.MOD	CLASSES:Beguiler=3	TYPE:Arcane
Hesitate.MOD	CLASSES:Beguiler=3	TYPE:Arcane
Hold Person.MOD	CLASSES:Beguiler=3	TYPE:Arcane
Inevitable Defeat.MOD	CLASSES:Beguiler=3	TYPE:Arcane
Invisibility Sphere.MOD	CLASSES:Beguiler=3	TYPE:Arcane
Legion of Sentinels.MOD	CLASSES:Beguiler=3	TYPE:Arcane
Major Image.MOD	CLASSES:Beguiler=3	TYPE:Arcane
Nondetection.MOD	CLASSES:Beguiler=3	TYPE:Arcane
Slow.MOD	CLASSES:Beguiler=3	TYPE:Arcane
Suggestion.MOD	CLASSES:Beguiler=3	TYPE:Arcane
Vertigo Field.MOD	CLASSES:Beguiler=3	TYPE:Arcane
Zone of Silence.MOD	CLASSES:Beguiler=3	TYPE:Arcane
Charm Monster.MOD	CLASSES:Beguiler=4	TYPE:Arcane
Confusion.MOD	CLASSES:Beguiler=4	TYPE:Arcane
Crushing Despair.MOD	CLASSES:Beguiler=4	TYPE:Arcane
Freedom of Movement.MOD	CLASSES:Beguiler=4	TYPE:Arcane
Invisibility (Greater).MOD	CLASSES:Beguiler=4	TYPE:Arcane
Mirror Image (Greater).MOD	CLASSES:Beguiler=4	TYPE:Arcane
Locate Creature.MOD	CLASSES:Beguiler=4	TYPE:Arcane
Whelm (Mass).MOD	CLASSES:Beguiler=4	TYPE:Arcane
Phantom Battle.MOD	CLASSES:Beguiler=4	TYPE:Arcane
Rainbow Pattern.MOD	CLASSES:Beguiler=4	TYPE:Arcane
Solid Fog.MOD	CLASSES:Beguiler=4	TYPE:Arcane
Break Enchantment.MOD	CLASSES:Beguiler=5	TYPE:Arcane
Dominate Person.MOD	CLASSES:Beguiler=5	TYPE:Arcane
Feeblemind.MOD	CLASSES:Beguiler=5	TYPE:Arcane
Friend to Foe.MOD	CLASSES:Beguiler=5	TYPE:Arcane
Hold Monster.MOD	CLASSES:Beguiler=5	TYPE:Arcane
Incite Riot.MOD	CLASSES:Beguiler=5	TYPE:Arcane
Mind Fog.MOD	CLASSES:Beguiler=5	TYPE:Arcane
Telepathic Bond.MOD	CLASSES:Beguiler=5	TYPE:Arcane
Seeming.MOD	CLASSES:Beguiler=5	TYPE:Arcane
Sending.MOD	CLASSES:Beguiler=5	TYPE:Arcane
Etherealness (Swift).MOD	CLASSES:Beguiler=5	TYPE:Arcane
Dispel Magic (Greater).MOD	CLASSES:Beguiler=6	TYPE:Arcane
Suggestion (Mass).MOD	CLASSES:Beguiler=6	TYPE:Arcane
Mislead.MOD	CLASSES:Beguiler=6	TYPE:Arcane
Overwhelm.MOD	CLASSES:Beguiler=6	TYPE:Arcane
Repulsion.MOD	CLASSES:Beguiler=6	TYPE:Arcane
Shadow Walk.MOD	CLASSES:Beguiler=6	TYPE:Arcane
True Seeing.MOD	CLASSES:Beguiler=6	TYPE:Arcane
Veil.MOD	CLASSES:Beguiler=6	TYPE:Arcane
Ethereal Jaunt.MOD	CLASSES:Beguiler=7	TYPE:Arcane
Arcane Sight (Greater).MOD	CLASSES:Beguiler=7	TYPE:Arcane
Hold Person (Mass).MOD	CLASSES:Beguiler=7	TYPE:Arcane
Invisibility (Mass).MOD	CLASSES:Beguiler=7	TYPE:Arcane
Phase Door.MOD	CLASSES:Beguiler=7	TYPE:Arcane
Power Word Blind.MOD	CLASSES:Beguiler=7	TYPE:Arcane
Project Image.MOD	CLASSES:Beguiler=7	TYPE:Arcane
Spell Turning.MOD	CLASSES:Beguiler=7	TYPE:Arcane
Demand.MOD	CLASSES:Beguiler=8	TYPE:Arcane
Discern Location.MOD	CLASSES:Beguiler=8	TYPE:Arcane
Mind Blank.MOD	CLASSES:Beguiler=8	TYPE:Arcane
Moment of Prescience.MOD	CLASSES:Beguiler=8	TYPE:Arcane
Power Word Stun.MOD	CLASSES:Beguiler=8	TYPE:Arcane
Scintillating Pattern.MOD	CLASSES:Beguiler=8	TYPE:Arcane
Screen.MOD	CLASSES:Beguiler=8	TYPE:Arcane
Dominate Monster.MOD	CLASSES:Beguiler=9	TYPE:Arcane
Etherealness.MOD	CLASSES:Beguiler=9	TYPE:Arcane
Foresight.MOD	CLASSES:Beguiler=9	TYPE:Arcane
Hold Monster (Mass).MOD	CLASSES:Beguiler=9	TYPE:Arcane
Power Word Kill.MOD	CLASSES:Beguiler=9	TYPE:Arcane
Time Stop.MOD	CLASSES:Beguiler=9	TYPE:Arcane
Blade of Blood.MOD	CLASSES:Assassin=1	TYPE:Divine
Increase Virulence.MOD	CLASSES:Assassin=2	TYPE:Divine
Blade of Blood.MOD	CLASSES:Blackguard=1	TYPE:Divine
Increase Virulence.MOD	CLASSES:Blackguard=2	TYPE:Divine
Bigby's Tripping Hand.MOD	CLASSES:Duskblade=1	TYPE:Arcane
Blade of Blood.MOD	CLASSES:Duskblade=1	TYPE:Arcane
Deflect (Lesser).MOD	CLASSES:Duskblade=1	TYPE:Arcane
Kelgore's Fire Bolt.MOD	CLASSES:Duskblade=1	TYPE:Arcane
Rouse.MOD	CLASSES:Duskblade=1	TYPE:Arcane
Stand.MOD	CLASSES:Duskblade=1	TYPE:Arcane
Animalistic Power.MOD	CLASSES:Duskblade=2	TYPE:Arcane
Bigby's Striking Fist.MOD	CLASSES:Duskblade=2	TYPE:Arcane
Deflect.MOD	CLASSES:Duskblade=2	TYPE:Arcane
Dimension Hop.MOD	CLASSES:Duskblade=2	TYPE:Arcane
Seeking Ray.MOD	CLASSES:Duskblade=2	TYPE:Arcane
Stretch Weapon.MOD	CLASSES:Duskblade=2	TYPE:Arcane
Sure Strike.MOD	CLASSES:Duskblade=2	TYPE:Arcane
Crown of Might.MOD	CLASSES:Duskblade=3	TYPE:Arcane
Crown of Protection.MOD	CLASSES:Duskblade=3	TYPE:Arcane
Dispelling Touch.MOD	CLASSES:Duskblade=3	TYPE:Arcane
Doom Scarabs.MOD	CLASSES:Duskblade=3	TYPE:Arcane
Energy Aegis.MOD	CLASSES:Duskblade=3	TYPE:Arcane
Energy Surge.MOD	CLASSES:Duskblade=3	TYPE:Arcane
Halt.MOD	CLASSES:Duskblade=3	TYPE:Arcane
Regroup.MOD	CLASSES:Duskblade=3	TYPE:Arcane
Channelled Pyroburst.MOD	CLASSES:Duskblade=4	TYPE:Arcane
Toxic Weapon.MOD	CLASSES:Duskblade=4	TYPE:Arcane
Slashing Dispel.MOD	CLASSES:Duskblade=5	TYPE:Arcane
Sonic Shield.MOD	CLASSES:Duskblade=5	TYPE:Arcane
