SOURCELONG:Planar Handbook	SOURCESHORT:PH	SOURCEWEB:http://www.gozzilioni.net																														
																												
###Block: AB																												
# Spell Name	Output Name	Spell Variations	Type	Classes of caster	Domains granting the spell	School	Sub-School	Spell Descriptors	Components	Casting Time	Range	TARGETAREA:		Duration	Save Info	Spell Resistance	DESC:	Source Page	Item	COST:	XPCOST:	PPCOST	Combat bonus	Bonus to HP	Stat bonus	Choose		
#
Interplanar Telepathic Bond.COPY=Rary's Interplanar Telepathic Bond
#
Charm Person.MOD	CLASSES:Fatemaker=1
Disguise Self.MOD	CLASSES:Fatemaker=1
Expeditious Retreat.MOD	CLASSES:Fatemaker=1
Jump.MOD	CLASSES:Fatemaker=1
Sanctuary.MOD	CLASSES:Fatemaker=1
True Strike.MOD	CLASSES:Fatemaker=1
Bear's Endurance.MOD	CLASSES:Fatemaker=2
Bull's Strength.MOD	CLASSES:Fatemaker=2
Cat's Grace.MOD	CLASSES:Fatemaker=2
Darkvision.MOD	CLASSES:Fatemaker=2
Daze Monster.MOD	CLASSES:Fatemaker=2
Eagle's Splendor.MOD	CLASSES:Fatemaker=2
Fox's Cunning.MOD	CLASSES:Fatemaker=2
Invisibility.MOD	CLASSES:Fatemaker=2
Owl's Wisdom.MOD	CLASSES:Fatemaker=2
Resist Energy.MOD	CLASSES:Fatemaker=2
Spider Climb.MOD	CLASSES:Fatemaker=2
Haste.MOD	CLASSES:Fatemaker=3
Protection from Energy.MOD	CLASSES:Fatemaker=3
Nondetection.MOD	CLASSES:Fatemaker=3
Suggestion.MOD	CLASSES:Fatemaker=3
Tongues.MOD	CLASSES:Fatemaker=3
Charm Monster.MOD	CLASSES:Fatemaker=4
Neutralize Poison.MOD	CLASSES:Fatemaker=4
Remove Curse.MOD	CLASSES:Fatemaker=4
Restoration.MOD	CLASSES:Fatemaker=4
Stoneskin.MOD	CLASSES:Fatemaker=4
