SOURCELONG:Draconomicon	SOURCESHORT:Drac	SOURCEWEB:http://www.gozzilioni.net																										
																												
###Block: AB																												
# Spell Name	Output Name	Spell Variations	Type	Classes of caster	Domains granting the spell	School	Sub-School	Spell Descriptors	Components	Casting Time	Range	TARGETAREA:		Duration	Save Info	Spell Resistance	DESC:	Source Page	Item	COST:	XPCOST:	PPCOST	Combat bonus	Bonus to HP	Stat bonus	Choose		
Detect Magic.MOD	CLASSES:Hoardstealer=1
Detect Secret Doors.MOD	CLASSES:Hoardstealer=1
Expeditious Retreat.MOD	CLASSES:Hoardstealer=1
Ghost Sound.MOD	CLASSES:Hoardstealer=1
Identify.MOD	CLASSES:Hoardstealer=1
Tenser's Floating Disk.MOD	CLASSES:Hoardstealer=1
Nystul's Magic Aura.MOD	CLASSES:Hoardstealer=1
Read Magic.MOD	CLASSES:Hoardstealer=1
Unseen Servant.MOD	CLASSES:Hoardstealer=1
Cat's Grace.MOD	CLASSES:Hoardstealer=2
Knock.MOD	CLASSES:Hoardstealer=2
Invisibility.MOD	CLASSES:Hoardstealer=2
Locate Object.MOD	CLASSES:Hoardstealer=2
Resist Energy.MOD	CLASSES:Hoardstealer=2
Spider Climb.MOD	CLASSES:Hoardstealer=2
Arcane Sight.MOD	CLASSES:Hoardstealer=3
Clairaudience/Clairvoyance.MOD	CLASSES:Hoardstealer=3
Dispel Magic.MOD	CLASSES:Hoardstealer=3
Protection from Energy.MOD	CLASSES:Hoardstealer=3
Shrink Item.MOD	CLASSES:Hoardstealer=3
Arcane Eye.MOD	CLASSES:Hoardstealer=4
Dimension Door.MOD	CLASSES:Hoardstealer=4
Freedom of Movement.MOD	CLASSES:Hoardstealer=4
Hide from Dragons.MOD	CLASSES:Hoardstealer=4