SOURCELONG:Power of Faerun	SOURCESHORT:PoF	SOURCEWEB:http://www.gozzilioni.net
		
#Teleport	CLASSES:Sorcerer,Wizard=5	TYPE:Arcane.Divine
Alarm.MOD	CLASSES:Merchant Prince=1	
Charm Person.MOD	CLASSES:Merchant Prince=1	
Comprehend Languages.MOD	CLASSES:Merchant Prince=1	
Create Water.MOD	CLASSES:Merchant Prince=1	
Cure Minor Wounds.MOD	CLASSES:Merchant Prince=1	
Detect Magic.MOD	CLASSES:Merchant Prince=1	
Erase.MOD	CLASSES:Merchant Prince=1	
Expeditious Retreat.MOD	CLASSES:Merchant Prince=1	
Feather Fall.MOD	CLASSES:Merchant Prince=1	
Know Direction.MOD	CLASSES:Merchant Prince=1	
Mage Armor.MOD	CLASSES:Merchant Prince=1	
Mage Hand.MOD	CLASSES:Merchant Prince=1	
Message.MOD	CLASSES:Merchant Prince=1	
Mount.MOD	CLASSES:Merchant Prince=1	
Prestidigitation.MOD	CLASSES:Merchant Prince=1	
Purify Food and Drink.MOD	CLASSES:Merchant Prince=1	
Read Magic.MOD	CLASSES:Merchant Prince=1	
Shield.MOD	CLASSES:Merchant Prince=1	
Unseen Servant.MOD	CLASSES:Merchant Prince=1	
Arcane Lock.MOD	CLASSES:Merchant Prince=2	
Continual Flame.MOD	CLASSES:Merchant Prince=2	
Cure Light Wounds.MOD	CLASSES:Merchant Prince=2	
Detect Thoughts.MOD	CLASSES:Merchant Prince=2	
Endure Elements.MOD	CLASSES:Merchant Prince=2	
Identify.MOD	CLASSES:Merchant Prince=2	
Locate Object.MOD	CLASSES:Merchant Prince=2	
Obscure Object.MOD	CLASSES:Merchant Prince=2	
Leomund's Tiny Hut.MOD	CLASSES:Merchant Prince=2	
Leomund's Trap.MOD	CLASSES:Merchant Prince=2	
Make Whole.MOD	CLASSES:Merchant Prince=2	
Misdirection.MOD	CLASSES:Merchant Prince=2	
Nystul's Magic Aura.MOD	CLASSES:Merchant Prince=2	
#Nystul's Undetectable Aura.MOD	CLASSES:Merchant Prince=2	
Protection from Arrows.MOD	CLASSES:Merchant Prince=2	
Tenser's Floating Disk.MOD	CLASSES:Merchant Prince=2	
Undetectable Alignment.MOD	CLASSES:Merchant Prince=2	
Whispering Wind.MOD	CLASSES:Merchant Prince=2	
Analyze Portal.MOD	CLASSES:Merchant Prince=3	
Create Food and Water.MOD	CLASSES:Merchant Prince=3	
Eagle's Splendor.MOD	CLASSES:Merchant Prince=3	
Fool's Gold.MOD	CLASSES:Merchant Prince=3	
Fox's Cunning.MOD	CLASSES:Merchant Prince=3	
Gembomb.MOD	CLASSES:Merchant Prince=3	
Knock.MOD	CLASSES:Merchant Prince=3	
Leomund's Secure Shelter.MOD	CLASSES:Merchant Prince=3	
Magic Mouth.MOD	CLASSES:Merchant Prince=3	
Owl's Wisdom.MOD	CLASSES:Merchant Prince=3	
Phantom Steed.MOD	CLASSES:Merchant Prince=3	
Resist Energy.MOD	CLASSES:Merchant Prince=3	
Secret Page.MOD	CLASSES:Merchant Prince=3	
See Invisibility.MOD	CLASSES:Merchant Prince=3	
Speak with Animals.MOD	CLASSES:Merchant Prince=3	
Tongues.MOD	CLASSES:Merchant Prince=3	
Arcane Mark.MOD	CLASSES:Court Herald=0	
Dancing Lights.MOD	CLASSES:Court Herald=0	
Detect Magic.MOD	CLASSES:Court Herald=0	
Detect Poison.MOD	CLASSES:Court Herald=0	
Light.MOD	CLASSES:Court Herald=0	
Mage Hand.MOD	CLASSES:Court Herald=0	
Mending.MOD	CLASSES:Court Herald=0	
Message.MOD	CLASSES:Court Herald=0	
Open/Close.MOD	CLASSES:Court Herald=0	
Read Magic.MOD	CLASSES:Court Herald=0	
Alarm.MOD	CLASSES:Court Herald=1	
Comprehend Languages.MOD	CLASSES:Court Herald=1	
Erase.MOD	CLASSES:Court Herald=1	
Feather Fall.MOD	CLASSES:Court Herald=1	
Identify.MOD	CLASSES:Court Herald=1	
Mage Armor.MOD	CLASSES:Court Herald=1	
Silence.MOD	CLASSES:Court Herald=1	
Silent Image.MOD	CLASSES:Court Herald=1	
Unseen Servant.MOD	CLASSES:Court Herald=1	
Arcane Lock.MOD	CLASSES:Court Herald=2	
Blur.MOD	CLASSES:Court Herald=2	
Darkness.MOD	CLASSES:Court Herald=2	
Darkvision.MOD	CLASSES:Court Herald=2	
Detect Thoughts.MOD	CLASSES:Court Herald=2	
Eagle's Splendor.MOD	CLASSES:Court Herald=2	
Invisibility.MOD	CLASSES:Court Herald=2	
Levitate.MOD	CLASSES:Court Herald=2	
Locate Object.MOD	CLASSES:Court Herald=2	
Magic Mouth.MOD	CLASSES:Court Herald=2	
Minor Image.MOD	CLASSES:Court Herald=2	
Mirror Image.MOD	CLASSES:Court Herald=2	
Misdirection.MOD	CLASSES:Court Herald=2	
Obscure Object.MOD	CLASSES:Court Herald=2	
Arcane Sight.MOD	CLASSES:Court Herald=3	
Clairaudience/Clairvoyance.MOD	CLASSES:Court Herald=3	
Daylight.MOD	CLASSES:Court Herald=3	
Detect Scrying.MOD	CLASSES:Court Herald=3	
Dispel Magic.MOD	CLASSES:Court Herald=3	
Explosive Runes.MOD	CLASSES:Court Herald=3	
Illusory Script.MOD	CLASSES:Court Herald=3	
Major Image.MOD	CLASSES:Court Herald=3	
Nondetection.MOD	CLASSES:Court Herald=3	
Secret Page.MOD	CLASSES:Court Herald=3	
Shrink Item.MOD	CLASSES:Court Herald=3	
Suggestion.MOD	CLASSES:Court Herald=3	
Tongues.MOD	CLASSES:Court Herald=3	
Water Breathing.MOD	CLASSES:Court Herald=3	
Arcane Eye.MOD	CLASSES:Court Herald=4	
Bestow Curse.MOD	CLASSES:Court Herald=4	
Confusion.MOD	CLASSES:Court Herald=4	
Detect Magic.MOD	CLASSES:Court Herald=4	
Dimension Door.MOD	CLASSES:Court Herald=4	
Dimensional Anchor.MOD	CLASSES:Court Herald=4	
Illusory Wall.MOD	CLASSES:Court Herald=4	
Locate Creature.MOD	CLASSES:Court Herald=4	
Minor Creation.MOD	CLASSES:Court Herald=4	
Neutralize Poison.MOD	CLASSES:Court Herald=4	
Rainbow Pattern.MOD	CLASSES:Court Herald=4	
Remove Curse.MOD	CLASSES:Court Herald=4	
Scrying.MOD	CLASSES:Court Herald=4	
Break Enchantment.MOD	CLASSES:Court Herald=5	
Dominate Person.MOD	CLASSES:Court Herald=5	
Dream.MOD	CLASSES:Court Herald=5	
Fabricate.MOD	CLASSES:Court Herald=5	
False Vision.MOD	CLASSES:Court Herald=5	
Feeblemind.MOD	CLASSES:Court Herald=5	
Major Creation.MOD	CLASSES:Court Herald=5	
Nightmare.MOD	CLASSES:Court Herald=5	
Permanency.MOD	CLASSES:Court Herald=5	
Persistent Image.MOD	CLASSES:Court Herald=5	
Prying Eyes.MOD	CLASSES:Court Herald=5	
Seeming.MOD	CLASSES:Court Herald=5	
Symbol of Pain.MOD	CLASSES:Court Herald=5	
Symbol of Sleep.MOD	CLASSES:Court Herald=5	
Sending.MOD	CLASSES:Court Herald=5	
Telekinesis.MOD	CLASSES:Court Herald=5	
Analyze Dweomer.MOD	CLASSES:Court Herald=6	
Antimagic Field.MOD	CLASSES:Court Herald=6	
Contingency.MOD	CLASSES:Court Herald=6	
Guards and Wards.MOD	CLASSES:Court Herald=6	
Legend Lore.MOD	CLASSES:Court Herald=6	
Eagle's Splendor (Mass).MOD	CLASSES:Court Herald=6	
Suggestion (Mass).MOD	CLASSES:Court Herald=6	
Mislead.MOD	CLASSES:Court Herald=6	
Permanent Image.MOD	CLASSES:Court Herald=6	
Programmed Image.MOD	CLASSES:Court Herald=6	
Symbol of Fear.MOD	CLASSES:Court Herald=6	
Symbol of Persuasion.MOD	CLASSES:Court Herald=6	
True Seeing.MOD	CLASSES:Court Herald=6	
