SOURCELONG:Gozzilioni	SOURCESHORT:G	SOURCEWEB:http://www.gozzilioni.net					
#	Sword, Spear, Axe, Bow, Unarmed						
#	Melee, Ranged, Thrown, Spell						
#	Bludgeoning, Slashing, Piercing						
#	TwoHanded, DoubleWeapon, MeleeTwoHanded, Reach						
#	MeleeSlashing, MeleePiercing, MeeleBludgeoning, RangedSlashing, RangedPiercing, RangedBludgeoning						
#	RangedTouch						
# Weapon Name			Type				Nb Hands
Axe (Orc Double).MOD	TYPE:Orcish						
Hammer (Gnome Hooked).MOD	TYPE:Gnomish						
Urgrosh (Dwarven).MOD	TYPE:Dwarven						
Waraxe (Dwarven).MOD	TYPE:Dwarven						
Whip.MOD	TYPE:Whip						
#							
Blowgun	TYPE:Simple.Ranged.Piercing.RangedPiercing.TwoHanded.Blowgun
Longbow (Aquatic)	TYPE:Exotic.Ranged.Piercing.RangedPiercing.TwoHanded.Bow.Longbow
#
Firearms	TYPE:Exotic.Piercing.MeleePiercing.Firearm.OneHanded						
Kusari-Gama	TYPE:Exotic.Melee.Piercing.MeleePiercing.Reach.TwoHanded						
Sword (Wakizashi)	TYPE:Martial.Melee.Piercing.MeleePiercing.Sword						
Sword (Katana)	TYPE:Martial.Exotic.Melee.Slashing.MeleeSlashing.Sword.TwoHanded						
Manacles	TYPE:Exotic						
#							
Gouger Tongue	TYPE:Natural.Melee.Piercing.MeleePiercing.Reach.Light						
Ice Toad Tongue	TYPE:Natural.Melee.Piercing.MeleePiercing.Reach.Light						
Bonedrinker Tentacle	TYPE:Natural.Melee.Piercing.MeleePiercing.Reach.Light						
Canoloth Tongue	TYPE:Natural.Melee.Piercing.MeleePiercing.Reach.Light						
Ahuizotl Tail Hand	TYPE:Natural.Melee.Bludgeoning.MeleeBludgeoning.Reach.Light						
Darkweaver Tentacle	TYPE:Natural.Melee.Bludgeoning.MeleeBludgeoning.Reach.Light						
Paeliryon Fingernail	TYPE:Natural.Melee.Slashing.Piercing.MeleeSlashing.MeleePiercing.Reach.Light						
Disenchanter Tongue	TYPE:Natural.Melee.Piercing.MeleePiercing.Reach.Light						
Hullathoin Tentacle	TYPE:Natural.Melee.Bludgeoning.MeleeBludgeoning.Reach.Light						
Ironmaw Tendril	TYPE:Natural.Melee.Bludgeoning.MeleeBludgeoning.Reach.Light						
Maulgoth Tentacle	TYPE:Natural.Melee.Bludgeoning.MeleeBludgeoning.Reach.Light						
Dama Fatale Tentacle	TYPE:Natural.Melee.Piercing.MeleePiercing.Reach.Light						
#							
Throath Dart	TYPE:Natural.Ranged.Piercing.RangedPiercing.Light						
Spit Fire	TYPE:Natural.Ranged.Unarmed.RangedTouch.Light						
Exploding Nodule	TYPE:Natural.Ranged.Unarmed.RangedTouch.Light						
Harpoon Spider Fang	TYPE:Natural.Ranged.Piercing.RangedPiercing.Light						
Vile Spew	TYPE:Natural.Ranged.Unarmed.RangedTouch.Light						
Splinterspit	TYPE:Natural.Ranged.Piercing.RangedPiercing.Light						
Spark Stream	TYPE:Natural.Ranged.Unarmed.RangedTouch.Light						
Poison Spray	TYPE:Natural.Ranged.Unarmed.RangedTouch.Light						
Spittle	TYPE:Natural.Ranged.Unarmed.RangedTouch.Light						
Bonespear Horn	TYPE:Natural.Ranged.Unarmed.Piercing.RangedPiercing.Light						
Flame Snake Magma Spit	TYPE:Natural.Ranged.Unarmed.RangedTouch.Light						
Winged Warrior Spike	TYPE:Natural.Ranged.Piercing.RangedPiercing.Light						
Animate Eyeball	TYPE:Natural.Ranged.Unarmed.RangedTouch.Light						
#							
Aboleth Bite	TYPE:Natural.Melee.Unarmed.Bludgeoning						
#