SOURCELONG:Ravenloft Player's Handbook	SOURCESHORT:RLPHB	SOURCEWEB:http://www.gozzilioni.net
		
#	other languages (races.rtf)	
Balok	TYPE:Spoken.Written.Read.Common
High Mordentish	TYPE:Spoken.Written.Read.Common
Low Mordentish	TYPE:Spoken.Written.Read.Common
Vaasi	TYPE:Spoken.Written.Read.Common
#
# Local languages										
Luktar	TYPE:Spoken.Written.Read									
Sithican	TYPE:Spoken.Written.Read									
Forfarian	TYPE:Spoken.Written.Read									
Thaani	TYPE:Spoken.Written.Read									
Darkonese	TYPE:Spoken.Written.Read									
Falkovnian	TYPE:Spoken.Written.Read									
Lamordian	TYPE:Spoken.Written.Read									
Tepestani	TYPE:Spoken.Written.Read									
Grabenite	TYPE:Spoken.Written.Read									
Vechorite	TYPE:Spoken.Written.Read									
#										
# Clusters										
Akiri	TYPE:Spoken.Written.Read									
Pharazian	TYPE:Spoken.Written.Read									
Wildspeak	TYPE:Spoken.Written.Read									
Sanguine	TYPE:Spoken.Written.Read									
Voros	TYPE:Spoken.Written.Read									
Nidalan	TYPE:Spoken.Written.Read									
Souragnian	TYPE:Spoken.Written.Read									
Rokuma	TYPE:Spoken.Written.Read									
Rajian	TYPE:Spoken.Written.Read									
Zherisian	TYPE:Spoken.Written.Read									
#										
# Islands of terror										
Odiaran	TYPE:Spoken.Written.Read									
#
# Vistani
Patterna	TYPE:Spoken	PRERACE:1,RACESUBTYPE=Half-Vistani,RACESUBTYPE=Vistani
Tralaks	TYPE:Written.Read	PRERACE:1,RACESUBTYPE=Half-Vistani,RACESUBTYPE=Vistani