SOURCELONG:Arms and Equipment Guide	SOURCESHORT:AaEG	SOURCEWEB:http://www.gozzilioni.net																								
#	#=IF(LOOKUP(CONCATENATE("#";A2);$A$4:$A$75)=CONCATENATE("#";A2);"";A2)																									
# Equipment Name	Output Name		Type	Cost	Weight	Base Quantity	Modifier	Requires Modification?	Source Page	Weapon prop. bonus	Special Property		REACHMULT:2	RANGE:	ALTTYPE:	ALTDAMAGE:	ALTCRITRANGE:	ALTCRITMULT:	ALTEQMOD:							
#Acid Fang Dagger	COST:19102																									
#Arrowdeath Flail	COST:33690																									
#Axe of Anger	COST:18320																									
#Axe of Falls	COST:50308																									
#Axe of Joyous Dance	COST:107906																									
#Axe of Pair	COST:50306																									
#Axe of Shards	COST:19330																									
#Axe of Storms	COST:98660																									
#Axe of Winds	COST:65830																									
#Badgerclaw	COST:32304																									
#Balor's Sword of Flame	COST:115870																									
#Balor's Sword of Lightning	COST:115870																									
#Balor's Sword of Smithing	COST:118670																									
#Balor's Sword of Soul Stealing	COST:219870																									
#Battleaxe of the Bull	COST:32310																									
#Blade of Deception	COST:19820																									
#Blade of Duelist	COST:16320																									
#Bonebreaker Hammer	COST:18312																									
#Breaking Blade	COST:18310																									
#Brutal Axe	COST:18310																									
#Celestial Blade	COST:18335																									
#Celestial Mace	COST:50312																									
#Chain of Entangling	COST:32325																									
#Changeling Spear	COST:18301																									
#Chargebreaker	COST:18305																									
#Claws of the Leopard	COST:38305																									
#Closing Blade	COST:58700																									
#Cutlass of Surety	COST:18310																									
#Dagger of Defense	COST:58302																									
#Dagger of Entry	COST:18502																									
#Desert's Heart	COST:71175																									
#Disarming Flail	COST:18395																									
#Doorbreaker	COST:8310																									
#Dragontooth	COST:40720																									
#Electric Lash	COST:50301																									
#Equestrian's Spear	COST:26615																									
#Erythnul's Slaughter	COST:72308																									
#Everburning Chain	COST:22725																									
#Fellstone	COST:32308																									
#Flail of Shadow	COST:48155																									
#Flameshroud Axe	COST:51510																									
#Foe Reaper	COST:32318																									
#Foretelling Blade	COST:18315																									
#Frost Shard Dagger	COST:1052																									
#Glaive of Torment	COST:74308																									
#Grasping Dagger	COST:50302																									
#Gruumsh's Revenge	COST:50305																									
#Guerrilla's Spear	COST:32302																									
#Guisarme of Long Falls	COST:18309																									
#Halberd of Vaulting	COST:20310																									
#Hammer of Sacrifice	COST:32312																									
#Hammer of the Magesmith	COST:45912																									
#Hand of Heironeous	COST:50315																									
#Havoc Blade	COST:98320																									
#Ice Talon	COST:24320																									
#Incandescent Sword	COST:72400																									
#Ioun Blade	COST:6302																									
#Kama of Pure Aim	COST:32302																									
#Knighr's Sword	COST:18335																									
#Kopesh of the Loyal Minion	COST:6320																									
#Kukri of Crippling	COST:18308																									
#Lance of Bravery	COST:30310																									
#Lance of Jousting	COST:32306																									
#Lance of Mangling	COST:18310																									
#Lance of the Unending Charge	COST:50310																									
#Mace of Form	COST:100312																									
#Mace of the Snail	COST:30992																									
#Mace of Unlife	COST:138312																									
#Mace of Voices	COST:37712																									
#Manticore Blade	COST:20350																									
#Maul of Construction	COST:51854																									
#Mirror Blade	COST:38315																									
#Nunchaku of Mastery	COST:22302																									
#Packmaster Flail	COST:48708																									
#Plague Spreader	COST:104715																									
#Raking Blade	COST:116700																									
#Rankbreaker Glaive	COST:32308																									
#Ranseur of Readyness	COST:50310																									
#Ringsword	COST:22315																									
#Sap of Stunning	COST:32301																									
#Sapling Club	COST:32540																									
#Scimitar of Colors	COST:36515																									
#Scimitar of Exertion	COST:18315																									
#Shield Blade	COST:10630																									
#Siangham of Focus	COST:19303																									
#Sickle of Talons	COST:26306																									
#Skullshaker Hammer	COST:18312																									
#Soldier's Rest	COST:4808																									
#Songblade	COST:6400																									
#Spear of Impaling	COST:32305																									
#Spear of the Hunt	COST:28302																									
#Spear of Skirmishing	COST:32301																									
#Spell Shield Falchion	COST:38708																									
#Spinning Blade	COST:50315																									
#Staff of Balance	COST:26600																									
#Staff of Discipline	COST:50600																									
#Staff of Memory	COST:32600																									
#Standard of Ulek	COST:23830																									
#Stone Spear	COST:32302																									
#Sword of Avoidance	COST:38315																									
#Sword of Countering	COST:33905																									
#Sword of Crypts	COST:42315																									
#Sword of the Diplomat	COST:64310																									
#Sword of Escape	COST:88310																									
#Sword of Graceful Strikes	COST:72310																									
#Sword of Judgment	COST:43115																									
#Sword of the Mammoth	COST:9350																									
#Sword of Opportunity	COST:18315																									
#Sword of Readyness	COST:36700																									
#Sword of Retribution	COST:72335																									
#Sword of Sanctuary	COST:19115																									
#Sword of the Solars	COST:3920335																									
#Sword of Versatility	COST:36700																									
#Sword of Zeal	COST:72315																									
#Tourney Lance	COST:50310																									
#Trident of the Depths	COST:8315																									
#Truestone Hammer	COST:51120																									
#Twin Blade	COST:29829																									
#Vanishing Blade	COST:47120																									
#Vigilant Halberd	COST:72310																									
#Viper Whip	COST:38301																									
#Warrenguard	COST:40310																									
#Weaponeater	COST:58300																									
#Whirlwind Axe	COST:18320																									
#Whisperblade	COST:48520																									
																										
# Equipment Name	Output Name		Type	Cost	Weight	Base Quantity	Modifier	Requires Modification?	Source Page	Weapon prop. bonus	Special Property		REACHMULT:2	RANGE												
Acid Fang Dagger		PROFICIENCY:WEAPON|Dagger	TYPE:Enhancement.Weapon.Melee.Finesseable.Ranged.Thrown.Simple.Specific.Piercing.Slashing.Dagger	COST:2	WT:1	WIELD:Light		SIZE:M	DAMAGE:1d4	CRITRANGE:2	CRITMULT:x2	EQMOD:STEEL.MWORKW.PLUS1W.CORR_M		RANGE:10						SOURCEPAGE:AaEG	MODS:NO	SPROP:1/day Animal Friendship 8HD snakes or reptiles. Speak with Animals with reptiles at will.				
Arrowdeath Flail		PROFICIENCY:WEAPON|Flail (Dire)	TYPE:Enhancement.Weapon.Melee.Exotic.Double.Specific.Bludgeoning.Flail	COST:90	WT:10	WIELD:TwoHanded	SLOTS:2	SIZE:M	DAMAGE:1d8	CRITRANGE:1	CRITMULT:x2	EQMOD:STEEL.MWORKW.PLUS2W			ALTTYPE:Enhancement.Weapon.Melee.Bludgeoning.Flail	ALTDAMAGE:1d8	ALTCRITRANGE:1	ALTCRITMULT:x2	ALTEQMOD:STEEL.MWORKW.PLUS1W	SOURCEPAGE:AaEG	MODS:NO					
Axe of Anger		PROFICIENCY:WEAPON|Battleaxe	TYPE:Enhancement.Weapon.Melee.Martial.Specific.Slashing.Axe	COST:10	WT:6	WIELD:OneHanded		SIZE:M	DAMAGE:1d8	CRITRANGE:1	CRITMULT:x3	EQMOD:STEEL.MWORKW.PLUS2W								SOURCEPAGE:AaEG	MODS:NO		BONUS:VAR|RageDuration|2			
Axe of Falls		PROFICIENCY:WEAPON|Axe (Throwing)	TYPE:Enhancement.Weapon.Melee.Finesseable.Ranged.Thrown.Martial.Specific.Slashing.Axe	COST:8	WT:2	WIELD:Light		SIZE:M	DAMAGE:1d6	CRITRANGE:1	CRITMULT:x2	EQMOD:STEEL.MWORKW.PLUS2W.RETRN		RANGE:10						SOURCEPAGE:AaEG	MODS:NO					
Axe of Pair		PROFICIENCY:WEAPON|Handaxe	TYPE:Enhancement.Weapon.Melee.Finesseable.Martial.Specific.Slashing.Axe	COST:6	WT:3	WIELD:Light		SIZE:M	DAMAGE:1d6	CRITRANGE:1	CRITMULT:x3	EQMOD:STEEL.MWORKW.PLUS2W								SOURCEPAGE:AaEG	MODS:NO		BONUS:COMBAT|SECONDARYATTACKS|1|PREEQUIPSECONDARY:1,Axe of Pair			
Axe of Shards		PROFICIENCY:WEAPON|Waraxe (Dwarven)	TYPE:Enhancement.Weapon.Melee.Martial.Exotic.Specific.Dwarven.Slashing.Axe	COST:30	WT:8	WIELD:TwoHanded		SIZE:M	DAMAGE:1d10	CRITRANGE:1	CRITMULT:x3	EQMOD:STEEL.MWORKW.PLUS3W								SOURCEPAGE:AaEG	MODS:NO		BONUS:WEAPON|WIELDCATEGORY|-1|PREFEAT:1,Exotic Weapon Proficiency (Waraxe (Dwarven))			
Axe of Storms		PROFICIENCY:WEAPON|Axe (Orc Double)	TYPE:Enhancement.Weapon.Melee.Exotic.Double.Specific.Orc.Slashing.Axe	COST:60	WT:15	WIELD:TwoHanded	SLOTS:2		DAMAGE:1d8	CRITRANGE:1	CRITMULT:x3	EQMOD:STEEL.MWORKW.PLUS1W.THNDR_M			ALTTYPE:Enhancement.Weapon.Melee.Slashing.Axe	ALTDAMAGE:1d8	ALTCRITRANGE:1	ALTCRITMULT:x3	ALTEQMOD:STEEL.MWORKW.PLUS1W.SHOCK_M	SOURCEPAGE:AaEG	MODS:NO	SPROP:you can choose how balance +4 enhancement bonus from one head to another each round from +0 to +4.				
Axe of Joyous Dance		PROFICIENCY:WEAPON|Handaxe	TYPE:Enhancement.Weapon.Melee.Finesseable.Martial.Specific.Slashing.Axe	COST:6	WT:3	WIELD:Light		SIZE:M	DAMAGE:1d6	CRITRANGE:1	CRITMULT:x3	EQMOD:STEEL.MWORKW.PLUS2W.DANCE								SOURCEPAGE:AaEG	MODS:NO	SPELLS:Axe of Joyous Dance|TIMES=1|CASTERLEVEL=4|Hideous Laughter,19				
Axe of Winds		PROFICIENCY:WEAPON|Battleaxe	TYPE:Enhancement.Weapon.Melee.Martial.Specific.Slashing.Axe	COST:10	WT:6	WIELD:OneHanded		SIZE:M	DAMAGE:1d8	CRITRANGE:1	CRITMULT:x3	EQMOD:STEEL.MWORKW.PLUS2W								SOURCEPAGE:AaEG	MODS:NO	SPELLS:Axe of Winds|TIMES=3|CASTERLEVEL=11|Gust of Wind,13	SPELLS:Axe of Winds|TIMES=1|CASTERLEVEL=11|Wind Wall			
Badgerclaw		PROFICIENCY:WEAPON|Pick (Light)	TYPE:Enhancement.Weapon.Melee.Finesseable.Martial.Specific.Piercing.Pick	COST:4	WT:3	WIELD:Light		SIZE:M	DAMAGE:1d4	CRITRANGE:1	CRITMULT:x4	EQMOD:STEEL.MWORKW.PLUS2W								SOURCEPAGE:AaEG	MODS:NO	SPELLS:Badgerclaw|TIMES=1|CASTERLEVEL=5|Stone Shape|Meld into Stone				
Balor's Sword of Flame		PROFICIENCY:WEAPON|Sword (Bastard)	TYPE:Enhancement.Weapon.Melee.Martial.Exotic.Specific.Slashing.Sword	COST:70	WT:12	WIELD:TwoHanded		SIZE:L	DAMAGE:2d6	CRITRANGE:2	CRITMULT:x2	EQMOD:STEEL.MWORKW.PLUS1W.VORPAL								SOURCEPAGE:AaEG	MODS:NO	SPROP:Detect good always active (12 th lvl caster).	BONUS:WEAPON|WIELDCATEGORY|-1|PREFEAT:1,Exotic Weapon Proficiency (Sword (Bastard))			
Balor's Sword of Lightning		PROFICIENCY:WEAPON|Sword (Bastard)	TYPE:Enhancement.Weapon.Melee.Martial.Exotic.Specific.Slashing.Sword	COST:70	WT:12	WIELD:TwoHanded		SIZE:L	DAMAGE:2d6	CRITRANGE:2	CRITMULT:x2	EQMOD:STEEL.MWORKW.PLUS1W.BRI_EN_M.SHOCK_M								SOURCEPAGE:AaEG	MODS:NO	SPROP:Detect law always active (12 th lvl caster).	BONUS:WEAPON|WIELDCATEGORY|-1|PREFEAT:1,Exotic Weapon Proficiency (Sword (Bastard))			
Balor's Sword of Smithing		PROFICIENCY:WEAPON|Sword (Bastard)	TYPE:Enhancement.Weapon.Melee.Martial.Exotic.Specific.Slashing.Sword	COST:70	WT:12	WIELD:TwoHanded		SIZE:L	DAMAGE:2d6	CRITRANGE:2	CRITMULT:x2	EQMOD:STEEL.MWORKW.PLUS5W.UNHLY_M								SOURCEPAGE:AaEG	MODS:NO	ABILITY:Special Ability|VIRTUAL|Smite Good	BONUS:WEAPON|WIELDCATEGORY|-1|PREFEAT:1,Exotic Weapon Proficiency (Sword (Bastard))	BONUS:VAR|SmiteGood|1		DEFINE:SmiteGoodDamage|10
Balor's Sword of Soul Stealing		PROFICIENCY:WEAPON|Sword (Bastard)	TYPE:Enhancement.Weapon.Melee.Martial.Exotic.Specific.Slashing.Sword	COST:70	WT:12	WIELD:TwoHanded		SIZE:L	DAMAGE:2d6	CRITRANGE:2	CRITMULT:x2	EQMOD:STEEL.MWORKW.PLUS3W.VORPAL								SOURCEPAGE:AaEG	MODS:NO	SPROP:Soul Bind.	BONUS:WEAPON|WIELDCATEGORY|-1|PREFEAT:1,Exotic Weapon Proficiency (Sword (Bastard))			
Battleaxe of the Bull		PROFICIENCY:WEAPON|Battleaxe	TYPE:Enhancement.Weapon.Melee.Martial.Specific.Slashing.Axe	COST:10	WT:6	WIELD:OneHanded		SIZE:M	DAMAGE:1d8	CRITRANGE:1	CRITMULT:x3	EQMOD:STEEL.MWORKW.PLUS2W								SOURCEPAGE:AaEG	MODS:NO	VFEAT:Improved Bull Rush				
Blade of Deception		PROFICIENCY:WEAPON|Rapier	TYPE:Enhancement.Weapon.Melee.Martial.Finesseable.Standard.Piercing.Sword	COST:20	WT:2	WIELD:OneHanded		SIZE:M	DAMAGE:1d6	CRITRANGE:3	CRITMULT:x2	EQMOD:STEEL.MWORKW.PLUS3W								SOURCEPAGE:AaEG	MODS:NO	SPROP:+2 Enhancement bonus on Bluff checks made to Feint.	BONUS:WEAPON|DAMAGEMULT:2|-0.5			
Blade of Duelist		PROFICIENCY:WEAPON|Rapier	TYPE:Enhancement.Weapon.Melee.Martial.Finesseable.Standard.Piercing.Sword	COST:20	WT:2	WIELD:OneHanded		SIZE:M	DAMAGE:1d6	CRITRANGE:3	CRITMULT:x2	EQMOD:STEEL.MWORKW.PLUS2W								SOURCEPAGE:AaEG	MODS:NO	SPROP:+2 insight bonus on AC, +2 bonus on disarm, when facing only a single foe.	BONUS:WEAPON|DAMAGEMULT:2|-0.5			
Bonebreaker Hammer		PROFICIENCY:WEAPON|Warhammer	TYPE:Enhancement.Weapon.Melee.Martial.Specific.Bludgeoning.Hammer	COST:12	WT:5	WIELD:OneHanded		SIZE:M	DAMAGE:1d8	CRITRANGE:1	CRITMULT:x3	EQMOD:STEEL.MWORKW.PLUS2W								SOURCEPAGE:AaEG	MODS:NO	SPROP:deal 1d6 Dex damage on critical hits.				
Breaking Blade		PROFICIENCY:WEAPON|Halberd	TYPE:Enhancement.Weapon.Melee.Martial.Specific.Piercing.Slashing.Polearm	COST:10	WT:12	WIELD:TwoHanded		SIZE:M	DAMAGE:1d10	CRITRANGE:1	CRITMULT:x3	EQMOD:STEEL.MWORKW.PLUS2W								SOURCEPAGE:AaEG	MODS:NO	SPROP:deal double damage when attacking simple and martial reach weapon. Hardness 15, 20 hit pints.				
Brutal Axe		PROFICIENCY:WEAPON|Battleaxe	TYPE:Enhancement.Weapon.Melee.Martial.Specific.Slashing.Axe	COST:10	WT:6	WIELD:OneHanded		SIZE:M	DAMAGE:1d8	CRITRANGE:1	CRITMULT:x3	EQMOD:STEEL.MWORKW.PLUS1W.KEEN								SOURCEPAGE:AaEG	MODS:NO	SPROP:free trip attack on successful critical hit.				
#Celestial Blade	see EXD
#Celestial Mace	see EXD
Chain of Entangling		PROFICIENCY:WEAPON|Chain (Spiked)	TYPE:Enhancement.Weapon.Melee.Exotic.Reach.Finesseable.Specific.Piercing.Chain	COST:25	WT:10	WIELD:TwoHanded	SLOTS:2	SIZE:M	DAMAGE:2d4	CRITRANGE:1	CRITMULT:x2	EQMOD:STEEL.MWORKW.PLUS2W	REACHMULT:2							SOURCEPAGE:AaEG	MODS:NO	SPROP:on hit, can grapple.				
Changeling Spear		PROFICIENCY:WEAPON|Halfspear	TYPE:Enhancement.Weapon.Melee.Ranged.Simple.Specific.Piercing.Thrown.Spear	COST:1	WT:3	WIELD:OneHanded		SIZE:M	DAMAGE:1d6	CRITRANGE:1	CRITMULT:x3	EQMOD:WOOD.MWORKW.PLUS1W		RANGE:20						SOURCEPAGE:AaEG	MODS:NO					
Chargebreaker		PROFICIENCY:WEAPON|Longspear	TYPE:Enhancement.Weapon.Melee.TwoHanded.Simple.Reach.Specific.Piercing.Spear	COST:5	WT:9	WIELD:TwoHanded		SIZE:M	DAMAGE:1d8	CRITRANGE:1	CRITMULT:x3	EQMOD:WOOD.MWORKW.PLUS1W.KEEN	REACHMULT:2							SOURCEPAGE:AaEG	MODS:NO	SPROP:triple damage when set against charging opponent.				
Claws of the Leopard		PROFICIENCY:WEAPON|Gauntlet (Spiked)	TYPE:Enhancement.Weapon.Melee.Finesseable.Simple.Specific.Piercing.Unarmed.Gauntlet	COST:5	WT:1	WIELD:Light		SIZE:M	DAMAGE:1d4	CRITRANGE:1	CRITMULT:x2	EQMOD:STEEL.MWORKW.PLUS2W								SOURCEPAGE:AaEG	MODS:NO	ABILITY:Special Ability|VIRTUAL|Pounce	BONUS:EQM|WEIGHTADD|-1|PREMULT:3,[PREEQUIP:1,TYPE.Armor],[PREEQUIP:1,TYPE.Medium,TYPE.Heavy],[!PREEQUIP:1,Breastplate]	VISION:Low-Light	BONUS:SKILL|Climb|10|TYPE=Enhancement	
Closing Blade		PROFICIENCY:WEAPON|Sword (Two-Bladed)	TYPE:Enhancement.Weapon.Melee.Exotic.Double.Specific.Slashing.Sword	COST:100	WT:10	WIELD:TwoHanded	SLOTS:2	SIZE:M	DAMAGE:1d8	CRITRANGE:2	CRITMULT:x2	EQMOD:STEEL.MWORKW.PLUS3W				ALTDAMAGE:1d8	ALTCRITRANGE:1	ALTCRITMULT:x2	ALTEQMOD:STEEL.MWORKW.PLUS2W	SOURCEPAGE:AaEG	MODS:NO	SPROP:when grappled the Closing Blade is treated as tiny.				
Cutlass of Surety		PROFICIENCY:WEAPON|Sword (Short)	TYPE:Enhancement.Weapon.Melee.Finesseable.Martial.Specific.Piercing.Sword	COST:10	WT:2	WIELD:Light		SIZE:M	DAMAGE:1d6	CRITRANGE:2	CRITMULT:x2	EQMOD:STEEL.MWORKW.PLUS2W								SOURCEPAGE:AaEG	MODS:NO	SPROP:cannot be disarmed.				
Dagger of Defense		PROFICIENCY:WEAPON|Dagger	TYPE:Enhancement.Weapon.Melee.Finesseable.Ranged.Thrown.Simple.Specific.Piercing.Slashing.Dagger	COST:2	WT:1	WIELD:Light		SIZE:M	DAMAGE:1d4	CRITRANGE:2	CRITMULT:x2	EQMOD:STEEL.MWORKW.PLUS4W.DEFEND		RANGE:10						SOURCEPAGE:AaEG	MODS:NO	SPROP:cannot be flanked except by 16th level rogues.|PREEQUIPSECONDARY:1,Dagger of Defense				
Dagger of Entry		PROFICIENCY:WEAPON|Dagger	TYPE:Enhancement.Weapon.Melee.Finesseable.Ranged.Thrown.Simple.Specific.Piercing.Slashing.Dagger	COST:2	WT:1	WIELD:Light		SIZE:M	DAMAGE:1d4	CRITRANGE:2	CRITMULT:x2	EQMOD:STEEL.MWORKW.PLUS1W		RANGE:10						SOURCEPAGE:AaEG	MODS:NO	SPELLS:Dagger of Entry|TIMES=1|CASTERLEVEL=9|Knock|Detect Secret Doors|Find Traps				
Desert's Heart		PROFICIENCY:WEAPON|Falchion	TYPE:Enhancement.Weapon.Melee.Martial.Specific.Slashing.Sword	COST:75	WT:8	WIELD:TwoHanded		SIZE:M	DAMAGE:2d4	CRITRANGE:3	CRITMULT:x2	EQMOD:STEEL.MWORKW.PLUS2W								SOURCEPAGE:AaEG	MODS:NO	ABILITY:Special Ability|VIRTUAL|Immunity To Fire|Vulnerability To Cold|!PRERACE:1,RACESUBTYPE=Cold	ABILITY:Special Ability|VIRTUAL|Negative Levels|PRERACE:1,RACESUBTYPE=Cold	BONUS:VAR|NegLevels|1|PRERACE:1,RACESUBTYPE=Cold		
Disarming Flail		PROFICIENCY:WEAPON|Flail (Heavy)	TYPE:Enhancement.Weapon.Melee.Martial.Specific.Bludgeoning.Flail	COST:15	WT:10	WIELD:TwoHanded		SIZE:M	DAMAGE:1d10	CRITRANGE:2	CRITMULT:x2	EQMOD:STEEL.MWORKW.PLUS2W								SOURCEPAGE:AaEG	MODS:NO	SPROP:+2 circumstance bonus on disarm check.	VFEAT:Improved Disarm			
Doorbreaker		PROFICIENCY:WEAPON|Battleaxe	TYPE:Enhancement.Weapon.Melee.Martial.Specific.Slashing.Axe	COST:10	WT:6	WIELD:OneHanded		SIZE:M	DAMAGE:1d8	CRITRANGE:1	CRITMULT:x3	EQMOD:STEEL.MWORKW.PLUS1W								SOURCEPAGE:AaEG	MODS:NO	SPROP:double damage against objects made predominantly of wood and plant creatures.				
Dragontooth		PROFICIENCY:WEAPON|Rapier	TYPE:Enhancement.Weapon.Melee.Martial.Finesseable.Specific.Piercing.Sword	COST:20	WT:2	WIELD:OneHanded		SIZE:M	DAMAGE:1d6	CRITRANGE:3	CRITMULT:x2	EQMOD:STEEL.MWORKW.PLUS2W.SHOCK_M								SOURCEPAGE:AaEG	MODS:NO	SPROP:Cause fear in 5th radius (Will DC 16)	BONUS:WEAPON|DAMAGEMULT:2|-0.5			
Electric Lash		PROFICIENCY:WEAPON|Whip	TYPE:Enhancement.Weapon.Melee.Exotic.Reach.Finesseable.Specific.Subdual.Slashing	COST:1	WT:2	WIELD:OneHanded		SIZE:M	DAMAGE:1d3	CRITRANGE:1	CRITMULT:x2	EQMOD:LEATHER.MWORKW.PLUS2W.SHOCK_M	REACH:15							SOURCEPAGE:AaEG	MODS:NO	SPROP:2/day Arcing Strike +2d6 electricity damage.				
Equestrian's Spear		PROFICIENCY:WEAPON|Longspear	TYPE:Enhancement.Weapon.Melee.TwoHanded.Simple.Reach.Specific.Piercing.Spear	COST:5	WT:9	WIELD:TwoHanded		SIZE:M	DAMAGE:1d8	CRITRANGE:1	CRITMULT:x3	EQMOD:WOOD.MWORKW.PLUS2W	REACHMULT:2							SOURCEPAGE:AaEG	MODS:NO	SPROP:if mounted, the spear function like a lance.|PREWEAPONPROF:1,Lance,Lance (Light)				
Erythnul's Slaughter		PROFICIENCY:WEAPON|Morningstar	TYPE:Enhancement.Weapon.Melee.Simple.Specific.Bludgeoning.Piercing.Mace	COST:8	WT:6	WIELD:OneHanded		SIZE:M	DAMAGE:1d8	CRITRANGE:1	CRITMULT:x2	EQMOD:STEEL.MWORKW.PLUS2W.UNHLY_M								SOURCEPAGE:AaEG	MODS:NO	SPROP:can prepare spells from war domain.|PRECLASS:1,Cleric=1				
Everburning Chain		PROFICIENCY:WEAPON|Chain (Spiked)	TYPE:Enhancement.Weapon.Melee.Exotic.Reach.Finesseable.Specific.Piercing.Chain	COST:25	WT:10	WIELD:TwoHanded	SLOTS:2	SIZE:M	DAMAGE:2d4	CRITRANGE:1	CRITMULT:x2	EQMOD:STEEL.MWORKW.PLUS2W.FLM_M	REACHMULT:2							SOURCEPAGE:AaEG	MODS:NO	SPROP:as standard action sweep 10-ft area dealing 1d6 fire damage (Reflex DC 13 for half).				
Fellstone		PROFICIENCY:WEAPON|Pick (Heavy)	TYPE:Enhancement.Weapon.Melee.Martial.Specific.Piercing.Pick	COST:8	WT:6	WIELD:OneHanded		SIZE:M	DAMAGE:1d6	CRITRANGE:1	CRITMULT:x4	EQMOD:STONE.MWORKW.PLUS3W								SOURCEPAGE:AaEG	MODS:NO	SPROP:Fort DC 13 or Dazed against Stone creature.	ABILITY:Special Ability|VIRTUAL|Earth Mastery			
Flail of Shadow		PROFICIENCY:WEAPON|Flail (Heavy)	TYPE:Enhancement.Weapon.Melee.Martial.Specific.Bludgeoning.Flail	COST:15	WT:10	WIELD:TwoHanded		SIZE:M	DAMAGE:1d10	CRITRANGE:2	CRITMULT:x2	EQMOD:STEEL.MWORKW.PLUS2W.SHDW_M								SOURCEPAGE:AaEG	MODS:NO	SPELLS:Flail of Shadow|TIMES=ATWILL|CASTERLEVEL=11|Dimension Door				
Flameshroud Axe		PROFICIENCY:WEAPON|Battleaxe	TYPE:Enhancement.Weapon.Melee.Martial.Specific.Slashing.Axe	COST:10	WT:6	WIELD:OneHanded		SIZE:M	DAMAGE:1d8	CRITRANGE:1	CRITMULT:x3	EQMOD:STEEL.MWORKW.PLUS3W.FLM_M								SOURCEPAGE:AaEG	MODS:NO	SPROP:1/day Fire Shield (chill version) as full round action.				
Foe Reaper		PROFICIENCY:WEAPON|Scythe	TYPE:Enhancement.Weapon.Melee.Martial.Specific.Piercing.Slashing.Scythe	COST:18	WT:10	WIELD:TwoHanded		SIZE:M	DAMAGE:2d4	CRITRANGE:1	CRITMULT:x4	EQMOD:STEEL.MWORKW.PLUS2W.MI_CLE								SOURCEPAGE:AaEG	MODS:NO	SPROP:double threat during extra cleaving attacks. Cannot benefit by keen edges or bless weapon or viciuos ability.				
Foretelling Blade		PROFICIENCY:WEAPON|Longsword	TYPE:Enhancement.Weapon.Melee.Martial.Specific.Slashing.Sword	COST:15	WT:4	WIELD:OneHanded		SIZE:M	DAMAGE:1d8	CRITRANGE:2	CRITMULT:x2	EQMOD:STEEL.MWORKW.PLUS2W								SOURCEPAGE:AaEG	MODS:NO					
Frost Shard Dagger		PROFICIENCY:WEAPON|Dagger	TYPE:Enhancement.Weapon.Melee.Finesseable.Ranged.Thrown.Simple.Specific.Piercing.Slashing.Dagger	COST:2	WT:1	WIELD:Light		SIZE:M	DAMAGE:1d4	CRITRANGE:2	CRITMULT:x2	EQMOD:STEEL.MWORKW.PLUS1W		RANGE:10						SOURCEPAGE:AaEG	MODS:NO	SPROP:after first succesfull attack cause 3d6 points of cold damage 5-ft radius (Ref DC 17 for half). Destroyed after one succesful use.				
Glaive of Torment		PROFICIENCY:WEAPON|Glaive	TYPE:Enhancement.Weapon.Melee.Martial.Reach.Specific.Slashing.Polearm	COST:8	WT:10	WIELD:TwoHanded		SIZE:M	DAMAGE:1d10	CRITRANGE:1	CRITMULT:x3	EQMOD:STEEL.MWORKW.PLUS1W.WOUND	REACHMULT:2							SOURCEPAGE:AaEG	MODS:NO	SPROP:-4 attack rolls, skill checks and ability checks for 3 rounds to target on succesfull hit (Fort DC 16 to half penalty).|PRERACE:1,Devil (Bearded (Barbazu))				
Grasping Dagger		PROFICIENCY:WEAPON|Dagger (Punching)	TYPE:Enhancement.Weapon.Melee.Finesseable.Simple.Specific.Piercing.Dagger	COST:2	WT:1	WIELD:Light		SIZE:M	DAMAGE:1d4	CRITRANGE:1	CRITMULT:x3	EQMOD:STEEL.MWORKW.PLUS3W.KEEN								SOURCEPAGE:AaEG	MODS:NO	SPROP:grapple as free action after succesful critical hit.				
Gruumsh's Revenge		PROFICIENCY:WEAPON|Longspear	TYPE:Enhancement.Weapon.Melee.TwoHanded.Simple.Reach.Specific.Piercing.Spear	COST:5	WT:9	WIELD:TwoHanded		SIZE:M	DAMAGE:1d8	CRITRANGE:1	CRITMULT:x3	EQMOD:WOOD.MWORKW.PLUS3W	REACHMULT:2							SOURCEPAGE:AaEG	MODS:NO					
Guerrilla's Spear		PROFICIENCY:WEAPON|Shortspear	TYPE:Enhancement.Weapon.Melee.Ranged.Thrown.Simple.Specific.Piercing.Spear	COST:1	WT:3	WIELD:OneHanded		SIZE:M	DAMAGE:1d6	CRITRANGE:1	CRITMULT:x3	EQMOD:WOOD.MWORKW.PLUS2W		RANGE:20						SOURCEPAGE:AaEG	MODS:NO	SPROP:+2d6 damage whenever an opponent is denied dexterity bonus  on armor.				
Guisarme of Long Falls		PROFICIENCY:WEAPON|Guisarme	TYPE:Enhancement.Weapon.Melee.Martial.Reach.Specific.Slashing.Polearm	COST:9	WT:12	WIELD:TwoHanded		SIZE:M	DAMAGE:2d4	CRITRANGE:1	CRITMULT:x3	EQMOD:STEEL.MWORKW.PLUS2W	REACHMULT:2							SOURCEPAGE:AaEG	MODS:NO	SPROP:stun on succesful trip attack (Fort DC 16).				
Halberd of Vaulting		PROFICIENCY:WEAPON|Halberd	TYPE:Enhancement.Weapon.Melee.Martial.Specific.Piercing.Slashing.Polearm	COST:10	WT:12	WIELD:TwoHanded		SIZE:M	DAMAGE:1d10	CRITRANGE:1	CRITMULT:x3	EQMOD:STEEL.MWORKW.PLUS2W								SOURCEPAGE:AaEG	MODS:NO		BONUS:SKILL|Jump|30			
Hammer of the Magesmith		PROFICIENCY:WEAPON|Warhammer	TYPE:Enhancement.Weapon.Melee.Martial.Specific.Bludgeoning.Hammer	COST:12	WT:5	WIELD:OneHanded		SIZE:M	DAMAGE:1d8	CRITRANGE:1	CRITMULT:x3	EQMOD:STEEL.MWORKW.PLUS1W								SOURCEPAGE:AaEG	MODS:NO	SPROP:Reduce raw materials when creating magic weapon by 5%% gold piece.	SPELLS:Hammer of the Magesmith|TIMES=1|CASTERLEVEL=10|Magic Weapon			
Hammer of Sacrifice		PROFICIENCY:WEAPON|Warhammer	TYPE:Enhancement.Weapon.Melee.Martial.Specific.Bludgeoning.Hammer	COST:12	WT:16	WIELD:OneHanded		SIZE:M	DAMAGE:1d8	CRITRANGE:1	CRITMULT:x3	EQMOD:STEEL.MWORKW.PLUS2W								SOURCEPAGE:AaEG	MODS:NO	SPROP:Sacrifice max 5 hp/round to increase damage by same amount.				
Hand of Heironeous		PROFICIENCY:WEAPON|Longsword	TYPE:Enhancement.Weapon.Melee.Martial.Specific.Slashing.Sword	COST:15	WT:4	WIELD:OneHanded		SIZE:M	DAMAGE:1d8	CRITRANGE:2	CRITMULT:x2	EQMOD:STEEL.MWORKW.PLUS3W								SOURCEPAGE:AaEG	MODS:NO	SPROP:+%d6 divine damage on succesful hit per turn undead spent.|max(1,CHA)				
Havoc Blade		PROFICIENCY:WEAPON|Greataxe	TYPE:Enhancement.Weapon.Melee.Martial.Specific.Slashing.Axe	COST:20	WT:12	WIELD:TwoHanded		SIZE:M	DAMAGE:1d12	CRITRANGE:1	CRITMULT:x3	EQMOD:STEEL.MWORKW.PLUS3W.KEEN.CHAOS_M								SOURCEPAGE:AaEG	MODS:NO	SPROP:on succesful critical hit Confusion (Will DC 19).				
Ice Talon		PROFICIENCY:WEAPON|Greataxe	TYPE:Enhancement.Weapon.Melee.Martial.Specific.Slashing.Axe	COST:20	WT:12	WIELD:TwoHanded		SIZE:M	DAMAGE:1d12	CRITRANGE:1	CRITMULT:x3	EQMOD:STEEL.MWORKW.PLUS2W.FROST_M								SOURCEPAGE:AaEG	MODS:NO		SPELLS:Ice Talon|TIMES=ATWILL|CASTERLEVEL=10|Endure Elements			
Incandescent Sword		PROFICIENCY:WEAPON|Greatsword	TYPE:Enhancement.Weapon.Melee.Martial.Specific.Slashing.Sword	COST:50	WT:8	WIELD:TwoHanded		SIZE:M	DAMAGE:2d6	CRITRANGE:2	CRITMULT:x2	EQMOD:STEEL.MWORKW.PLUS4W.HOLY_M.LGHT_EMIT								SOURCEPAGE:AaEG	MODS:NO					
Ioun Blade		PROFICIENCY:WEAPON|Dagger	TYPE:Enhancement.Weapon.Melee.Finesseable.Ranged.Thrown.Simple.Specific.Piercing.Slashing.Dagger.Container	COST:2	WT:1	WIELD:Light		SIZE:M	DAMAGE:1d4	CRITRANGE:2	CRITMULT:x2	EQMOD:STEEL.MWORKW.PLUS1W		RANGE:10						SOURCEPAGE:AaEG	MODS:NO		CONTAINS:1|IounStone=1			
Kama of Pure Aim		PROFICIENCY:WEAPON|Kama	TYPE:Enhancement.Weapon.Melee.Finesseable.Exotic.Specific.Monk.Slashing.Kama	COST:2	WT:2	WIELD:Light		SIZE:M	DAMAGE:1d6	CRITRANGE:1	CRITMULT:x2	EQMOD:STEEL.MWORKW.PLUS2W								SOURCEPAGE:AaEG	MODS:NO					
Kopesh of the Loyal Minion		PROFICIENCY:WEAPON|Sword (Kopesh)	TYPE:Enhancement.Weapon.Melee.Exotic.Specific.Slashing.Sword	COST:20	WT:12	WIELD:OneHanded		SIZE:M	DAMAGE:1d8	CRITRANGE:2	CRITMULT:x2	EQMOD:STEEL.MWORKW.PLUS1W								SOURCEPAGE:AaEG	MODS:NO	SPROP:act as if Magic Fang spell if morphed into a form that has Claw attack.				
Knighr's Sword		PROFICIENCY:WEAPON|Sword (Bastard)	TYPE:Enhancement.Weapon.Melee.Martial.Exotic.Specific.Slashing.Sword	COST:70	WT:12	WIELD:TwoHanded		SIZE:M	DAMAGE:1d10	CRITRANGE:2	CRITMULT:x2	EQMOD:STEEL.MWORKW.PLUS2W								SOURCEPAGE:AaEG	MODS:NO	SPROP:double damage on charge attack when riding a mount.	BONUS:WEAPON|WIELDCATEGORY|-1|PREFEAT:1,Exotic Weapon Proficiency (Sword (Bastard))			
Kukri of Crippling		PROFICIENCY:WEAPON|Kukri	TYPE:Enhancement.Weapon.Melee.Finesseable.Martial.Specific.Slashing.Dagger	COST:8	WT:2	WIELD:Light		SIZE:M	DAMAGE:1d4	CRITRANGE:3	CRITMULT:x2	EQMOD:STEEL.MWORKW.PLUS2W								SOURCEPAGE:AaEG	MODS:NO	SPROP:target movement rate is halved on successful critical hits for 1 day (or Heal check DC 15 or receive at least 1 hp of magical healing).				
Lance of Bravery		PROFICIENCY:WEAPON|Lance	TYPE:Enhancement.Weapon.Melee.Martial.Reach.Specific.Piercing.Lance	COST:10	WT:10	WIELD:TwoHanded		SIZE:M	DAMAGE:1d8	CRITRANGE:1	CRITMULT:x3	EQMOD:WOOD.MWORKW.PLUS2W	REACHMULT:2							SOURCEPAGE:AaEG	MODS:NO	ABILITY:Special Ability|VIRTUAL|Immunity To Fear				
Lance of Jousting		PROFICIENCY:WEAPON|Lance	TYPE:Enhancement.Weapon.Melee.Martial.Reach.Specific.Piercing.Lance	COST:6	WT:5	WIELD:TwoHanded		SIZE:S	DAMAGE:1d6	CRITRANGE:1	CRITMULT:x3	EQMOD:WOOD.MWORKW.PLUS3W	REACH:10							SOURCEPAGE:AaEG	MODS:NO					
Lance of Mangling		PROFICIENCY:WEAPON|Lance	TYPE:Enhancement.Weapon.Melee.Martial.Reach.Specific.Piercing.Lance	COST:10	WT:10	WIELD:TwoHanded		SIZE:M	DAMAGE:1d8	CRITRANGE:1	CRITMULT:x3	EQMOD:WOOD.MWORKW.PLUS2W	REACHMULT:2							SOURCEPAGE:AaEG	MODS:NO	SPROP:destroy an opponent's shield with a successful critical hits.				
Lance of the Unending Charge		PROFICIENCY:WEAPON|Lance	TYPE:Enhancement.Weapon.Melee.Martial.Reach.Specific.Piercing.Lance	COST:10	WT:10	WIELD:TwoHanded		SIZE:M	DAMAGE:1d8	CRITRANGE:1	CRITMULT:x3	EQMOD:WOOD.MWORKW.PLUS2W.MI_CLE	REACHMULT:2							SOURCEPAGE:AaEG	MODS:NO	SPROP:can move up to the limit of her mount's movement in the charge direction before making extra attack.				
Mace of Form		PROFICIENCY:WEAPON|Mace (Light)	TYPE:Enhancement.Weapon.Melee.Finesseable.Simple.Specific.Bludgeoning.Mace	COST:5	WT:4	WIELD:Light		SIZE:M	DAMAGE:1d6	CRITRANGE:1	CRITMULT:x2	EQMOD:STEEL.MWORKW.PLUS2W.BANE_M_ASHP								SOURCEPAGE:AaEG	MODS:NO					
Mace of the Snail		PROFICIENCY:WEAPON|Mace (Heavy)	TYPE:Enhancement.Weapon.Melee.Simple.Specific.Bludgeoning.Mace	COST:12	WT:8	WIELD:OneHanded		SIZE:M	DAMAGE:1d8	CRITRANGE:1	CRITMULT:x2	EQMOD:STEEL.MWORKW.PLUS2W								SOURCEPAGE:AaEG	MODS:NO	SPROP:+2 bonus to AC when Total Defense action.	SPELLS:Mace of the Snail|TIMES=3|CASTERLEVEL=6|Slow,14			
Mace of Unlife		PROFICIENCY:WEAPON|Mace (Heavy)	TYPE:Enhancement.Weapon.Melee.Simple.Specific.Bludgeoning.Mace	COST:12	WT:8	WIELD:OneHanded		SIZE:M	DAMAGE:1d8	CRITRANGE:1	CRITMULT:x2	EQMOD:STEEL.MWORKW.PLUS3W								SOURCEPAGE:AaEG	MODS:NO	SPROP:when deliver the killing blow can rise the creature as a controlled zombie (full round action). Up to 20 HD of controlled Zombie.				
Mace of Voices		PROFICIENCY:WEAPON|Mace (Heavy)	TYPE:Enhancement.Weapon.Melee.Simple.Specific.Bludgeoning.Mace	COST:12	WT:8	WIELD:OneHanded		SIZE:M	DAMAGE:1d8	CRITRANGE:1	CRITMULT:x2	EQMOD:STEEL.MWORKW.PLUS2W.THNDR_M								SOURCEPAGE:AaEG	MODS:NO	SPROP:can cast Enthrall per Turn Undead spent.	BONUS:SKILL|Diplomacy|2			
Mageblade		PROFICIENCY:WEAPON|Longsword	TYPE:Enhancement.Weapon.Melee.Martial.Specific.Slashing.Sword	COST:15	WT:4	WIELD:OneHanded		SIZE:M	DAMAGE:1d8	CRITRANGE:2	CRITMULT:x2	EQMOD:STEEL.MWORKW.PLUS2W.SPL_STR								SOURCEPAGE:AaEG	MODS:NO					
Manticore Blade		PROFICIENCY:WEAPON|Greatsword	TYPE:Enhancement.Weapon.Melee.Martial.Specific.Slashing.Sword.Double	COST:50	WT:8	WIELD:TwoHanded		SIZE:M	DAMAGE:2d6	CRITRANGE:2	CRITMULT:x2	EQMOD:STEEL.MWORKW.PLUS3W			ALTTYPE:Enhancement.Weapon.Ranged.Piercing	ALTDAMAGE:1d6	ALTCRITRANGE:1	ALTCRITMULT:x2	ALTEQMOD:STEEL.MWORKW.PLUS1W	SOURCEPAGE:AaEG	MODS:NO					
Maul of Construction		PROFICIENCY:WEAPON|Warhammer	TYPE:Enhancement.Weapon.Melee.Martial.Specific.Bludgeoning.Hammer	COST:12	WT:16	WIELD:OneHanded		SIZE:L	DAMAGE:2d6	CRITRANGE:1	CRITMULT:x3	EQMOD:STEEL.MWORKW.PLUS2W								SOURCEPAGE:AaEG	MODS:NO	SPELLS:Maul of Construction|TIMES=1|CASTERLEVEL=15|Stone Shape|Wall of Stone				
Mirror Blade		PROFICIENCY:WEAPON|Longsword	TYPE:Enhancement.Weapon.Melee.Martial.Specific.Slashing.Sword	COST:15	WT:4	WIELD:OneHanded		SIZE:M	DAMAGE:1d8	CRITRANGE:2	CRITMULT:x2	EQMOD:STEEL.MWORKW.PLUS2W.LGHT_EMIT								SOURCEPAGE:AaEG	MODS:NO	SPROP:dazzle 5'-ft radius (Will DC 15)				
Morningstar of Exhilaration		PROFICIENCY:WEAPON|Morningstar	TYPE:Enhancement.Weapon.Melee.Simple.Specific.Bludgeoning.Piercing.Mace	COST:8	WT:6	WIELD:OneHanded		SIZE:M	DAMAGE:1d8	CRITRANGE:1	CRITMULT:x2	EQMOD:STEEL.MWORKW.PLUS2W								SOURCEPAGE:AaEG	MODS:NO					
Nunchaku of Mastery		PROFICIENCY:WEAPON|Nunchaku	TYPE:Enhancement.Weapon.Melee.Finesseable.Exotic.Specific.Monk.Bludgeoning.Nunchaku	COST:2	WT:2	WIELD:Light		SIZE:M	DAMAGE:1d6	CRITRANGE:1	CRITMULT:x2	EQMOD:WOOD.MWORKW.PLUS2W								SOURCEPAGE:AaEG	MODS:NO	SPROP:+20 bonus to hit next attack after spending one full round twirling.				
Packmaster Flail		PROFICIENCY:WEAPON|Flail	TYPE:Enhancement.Weapon.Melee.Martial.Specific.Bludgeoning.Flail	COST:8	WT:5	WIELD:OneHanded		SIZE:M	DAMAGE:1d8	CRITRANGE:1	CRITMULT:x2	EQMOD:STEEL.MWORKW.PLUS2W.BANE_M|Humanoids (gnoll)								SOURCEPAGE:AaEG	MODS:NO	SPROP:+10 bonus on Intimidate and Diplomacy checks made against Gnolls.	ABILITY:Special Ability|VIRTUAL|Summon Fiendish Gnoll (Sp)	DEFINE:SummonFiendishGnollPerDay|1		
Piercing Tongue of Kath Kadan		PROFICIENCY:WEAPON|Longspear	TYPE:Enhancement.Weapon.Melee.TwoHanded.Simple.Reach.Specific.Piercing.Spear	COST:5	WT:27	WIELD:TwoHanded		SIZE:H	DAMAGE:2d8	CRITRANGE:1	CRITMULT:x3	EQMOD:WOOD.MWORKW.PLUS3W.FLM_M	REACHMULT:2							SOURCEPAGE:AaEG	MODS:NO					
Plague Spreader		PROFICIENCY:WEAPON|Flail (Heavy)	TYPE:Enhancement.Weapon.Melee.Martial.Specific.Bludgeoning.Flail	COST:15	WT:10	WIELD:TwoHanded		SIZE:M	DAMAGE:1d10	CRITRANGE:2	CRITMULT:x2	EQMOD:STEEL.MWORKW.PLUS3W								SOURCEPAGE:AaEG	MODS:NO	SPROP:Filth Fever disease infection after succesfull hit (Fort DC 20).	ABILITY:Special Ability|VIRTUAL|Disease			
Raking Blade		PROFICIENCY:WEAPON|Sword (Two-Bladed)	TYPE:Enhancement.Weapon.Melee.Exotic.Double.Specific.Slashing.Sword	COST:100	WT:10	WIELD:TwoHanded	SLOTS:2	SIZE:M	DAMAGE:1d8	CRITRANGE:2	CRITMULT:x2	EQMOD:STEEL.MWORKW.PLUS4W				ALTDAMAGE:1d8	ALTCRITRANGE:1	ALTCRITMULT:x2	ALTEQMOD:STEEL.MWORKW.PLUS3W	SOURCEPAGE:AaEG	MODS:NO	SPROP:everytime hits with first primary and first off-hand attack, ypu can make an extra attack at -5 on wielder's best attack bonus.				
Rankbreaker Glaive		PROFICIENCY:WEAPON|Glaive	TYPE:Enhancement.Weapon.Melee.Martial.Reach.Specific.Slashing.Polearm	COST:8	WT:10	WIELD:TwoHanded		SIZE:M	DAMAGE:1d10	CRITRANGE:1	CRITMULT:x3	EQMOD:STEEL.MWORKW.PLUS2W	REACHMULT:2							SOURCEPAGE:AaEG	MODS:NO		ABILITY:FEAT|VIRTUAL|Cleave			
Ranseur of Readyness		PROFICIENCY:WEAPON|Ranseur	TYPE:Enhancement.Weapon.Melee.Martial.Reach.Specific.Piercing.Polearm	COST:10	WT:12	WIELD:TwoHanded		SIZE:M	DAMAGE:2d4	CRITRANGE:1	CRITMULT:x3	EQMOD:STEEL.MWORKW.PLUS2W.EAG	REACHMULT:2							SOURCEPAGE:AaEG	MODS:NO					
Ringsword		PROFICIENCY:WEAPON|Longsword	TYPE:Enhancement.Weapon.Melee.Martial.Specific.Slashing.Sword	COST:15	WT:4	WIELD:OneHanded		SIZE:M	DAMAGE:1d8	CRITRANGE:2	CRITMULT:x2	EQMOD:STEEL.MWORKW.PLUS3W								SOURCEPAGE:AaEG	MODS:NO		BONUS:SLOTS|RING|1			
Sap of Stunning		PROFICIENCY:WEAPON|Sap	TYPE:Enhancement.Weapon.Melee.Finesseable.Martial.Subdual.Specific.Bludgeoning.Sap	COST:1	WT:2	WIELD:Light		SIZE:M	DAMAGE:1d6	CRITRANGE:1	CRITMULT:x2	EQMOD:LEATHER.MWORKW.PLUS2W								SOURCEPAGE:AaEG	MODS:NO	SPROP:Stun (Fort DC 15) an opponent who is denied his Dexterity.				
Sapling Club		PROFICIENCY:WEAPON|Club	TYPE:Enhancement.Weapon.Melee.Ranged.Thrown.Simple.Specific.Bludgeoning.Club	COST:0	WT:3	WIELD:OneHanded		SIZE:M	DAMAGE:1d6	CRITRANGE:1	CRITMULT:x2	EQMOD:WOOD.MWORKW.PLUS1W		RANGE:10						SOURCEPAGE:AaEG	MODS:NO	SPROP:1/day transform into a Treant.				
Scimitar of Colors		PROFICIENCY:WEAPON|Scimitar	TYPE:Enhancement.Weapon.Melee.Martial.Specific.Slashing.Sword	COST:15	WT:4	WIELD:OneHanded		SIZE:M	DAMAGE:1d6	CRITRANGE:3	CRITMULT:x2	EQMOD:STEEL.MWORKW.PLUS3W								SOURCEPAGE:AaEG	MODS:NO					
Scimitar of Exertion		PROFICIENCY:WEAPON|Scimitar	TYPE:Enhancement.Weapon.Melee.Martial.Specific.Slashing.Sword	COST:15	WT:4	WIELD:OneHanded		SIZE:M	DAMAGE:1d6	CRITRANGE:3	CRITMULT:x2	EQMOD:STEEL.MWORKW.PLUS2W								SOURCEPAGE:AaEG	MODS:NO	SPROP:increase and decrease Strength on command word.				
Scourge of the Pomarj		PROFICIENCY:WEAPON|Flail (Dire)	TYPE:Enhancement.Weapon.Melee.Exotic.Double.Specific.Bludgeoning.Flail	COST:90	WT:10	WIELD:TwoHanded	SLOTS:2	SIZE:M	DAMAGE:1d8	CRITRANGE:1	CRITMULT:x2	EQMOD:STEEL.MWORKW.PLUS2W.BANE_M|Monstrous humanoids			ALTTYPE:Enhancement.Weapon.Melee.Bludgeoning.Flail	ALTDAMAGE:1d8	ALTCRITRANGE:1	ALTCRITMULT:x2	ALTEQMOD:STEEL.MWORKW.PLUS2W.BANE_M|Humanoids (goblinoid)	SOURCEPAGE:AaEG	MODS:NO	SPROP:can understand Orc and Goblinoid, but cannot speak, if wield.				
Shield Blade		PROFICIENCY:WEAPON|Sword (Short)	TYPE:Enhancement.Weapon.Melee.Finesseable.Martial.Specific.Piercing.Sword	COST:10	WT:2	WIELD:Light		SIZE:M	DAMAGE:1d6	CRITRANGE:2	CRITMULT:x2	EQMOD:STEEL.MWORKW.PLUS2W								SOURCEPAGE:AaEG	MODS:NO					
Siangham of Focus		PROFICIENCY:WEAPON|Siangham	TYPE:Enhancement.Weapon.Melee.Finesseable.Exotic.Specific.Monk.Piercing.Siangham	COST:3	WT:1	WIELD:Light		SIZE:M	DAMAGE:1d6	CRITRANGE:1	CRITMULT:x2	EQMOD:STEEL.MWORKW.PLUS3W								SOURCEPAGE:AaEG	MODS:NO	SPROP:can be used to Stunninf Fist. +2 Enhancement bonus on reflex save using Deflect Arrows feat.				
Sickle of Talons		PROFICIENCY:WEAPON|Sickle	TYPE:Enhancement.Weapon.Melee.Light.Finesseable.Simple.Specific.Slashing.Sickle	COST:6	WT:2	WIELD:Light		SIZE:M	DAMAGE:1d6	CRITRANGE:1	CRITMULT:x2	EQMOD:STEEL.MWORKW.PLUS2W.KEEN								SOURCEPAGE:AaEG	MODS:NO	SPROP:act as if Magic Fang spell if morphed into a form that has Claw or Bite attack.				
Skullshaker Hammer		PROFICIENCY:WEAPON|Warhammer	TYPE:Enhancement.Weapon.Melee.Martial.Specific.Bludgeoning.Hammer	COST:12	WT:5	WIELD:OneHanded		SIZE:M	DAMAGE:1d8	CRITRANGE:1	CRITMULT:x3	EQMOD:STEEL.MWORKW.PLUS2W								SOURCEPAGE:AaEG	MODS:NO	SPROP:3/day deals additional 1d6 points of WIS damage on succesful hit.				
Soldier's Rest		PROFICIENCY:WEAPON|Glaive	TYPE:Enhancement.Weapon.Melee.Martial.Reach.Specific.Slashing.Polearm	COST:8	WT:10	WIELD:TwoHanded		SIZE:M	DAMAGE:1d10	CRITRANGE:1	CRITMULT:x3	EQMOD:STEEL.MWORKW.PLUS1W	REACHMULT:2							SOURCEPAGE:AaEG	MODS:NO	SPROP:the wielder ignore fatigue effects until exhausted.				
Songblade		PROFICIENCY:WEAPON|Rapier	TYPE:Enhancement.Weapon.Melee.Martial.Finesseable.Standard.Piercing.Sword	COST:20	WT:2	WIELD:OneHanded		SIZE:M	DAMAGE:1d6	CRITRANGE:3	CRITMULT:x2	EQMOD:STEEL.MWORKW.PLUS1W								SOURCEPAGE:AaEG	MODS:NO		BONUS:SKILL|TYPE.Perform|2|TYPE=Enhancement	BONUS:VAR|BardicMusicTimes|1		
Spear of Impaling		PROFICIENCY:WEAPON|Longspear	TYPE:Enhancement.Weapon.Melee.TwoHanded.Simple.Reach.Specific.Piercing.Spear	COST:5	WT:9	WIELD:TwoHanded		SIZE:M	DAMAGE:1d8	CRITRANGE:1	CRITMULT:x3	EQMOD:WOOD.MWORKW.PLUS2W	REACHMULT:2							SOURCEPAGE:AaEG	MODS:NO	SPROP:grapple as free action after succesful critical hit.				
Spear of the Hunt		PROFICIENCY:WEAPON|Shortspear	TYPE:Enhancement.Weapon.Melee.Ranged.Thrown.Simple.Specific.Piercing.Spear	COST:1	WT:3	WIELD:OneHanded		SIZE:M	DAMAGE:1d6	CRITRANGE:1	CRITMULT:x3	EQMOD:WOOD.MWORKW.PLUS1W.BANE_M|Animals		RANGE:20						SOURCEPAGE:AaEG	MODS:NO	SPROP:+2d6 damage whenever an opponent is denied dexterity bonus  on armor.	ABILITY:FEAT|VIRTUAL|Track			
Spear of Skirmishing		PROFICIENCY:WEAPON|Halfspear	TYPE:Enhancement.Weapon.Melee.Ranged.Simple.Specific.Piercing.Thrown.Spear	COST:1	WT:3	WIELD:OneHanded		SIZE:M	DAMAGE:1d6	CRITRANGE:1	CRITMULT:x3	EQMOD:WOOD.MWORKW.PLUS2W.RETRN		RANGE:20						SOURCEPAGE:AaEG	MODS:NO	SPROP:any round the wielder throw the spear, he can add 10 feet to his speed.				
Spell Shield Falchion		PROFICIENCY:WEAPON|Falchion	TYPE:Enhancement.Weapon.Melee.Martial.Specific.Slashing.Sword	COST:75	WT:8	WIELD:TwoHanded		SIZE:M	DAMAGE:2d4	CRITRANGE:3	CRITMULT:x2	EQMOD:STEEL.MWORKW.PLUS2W								SOURCEPAGE:AaEG	MODS:NO	SPROP:Spell Turning when total defense.				
Spinning Blade		PROFICIENCY:WEAPON|Scimitar	TYPE:Enhancement.Weapon.Melee.Martial.Specific.Slashing.Sword	COST:15	WT:4	WIELD:OneHanded		SIZE:M	DAMAGE:1d6	CRITRANGE:3	CRITMULT:x2	EQMOD:STEEL.MWORKW.PLUS2W.RETRN.THROW								SOURCEPAGE:AaEG	MODS:NO	SPROP:ranged disarm.				
Staff of Balance		PROFICIENCY:WEAPON|Quarterstaff	TYPE:Weapon.Melee.TwoHanded.Simple.Double.Standard.Bludgeoning.Quarterstaff	COST:0	WT:4	WIELD:TwoHanded		SIZE:M	DAMAGE:1d6	CRITRANGE:1	CRITMULT:x2	EQMOD:WOOD.MWORKW.PLUS2W			ALTTYPE:Enhancement.Weapon.Melee.Bludgeoning	ALTDAMAGE:1d6	ALTCRITRANGE:1	ALTCRITMULT:x2	ALTEQMOD:WOOD.MWORKW.PLUS2W	SOURCEPAGE:AaEG	MODS:NO	SPROP:+10 enhancement bonus on Balance when holding two handed and not attacking. +4 enhancement bonus on strengt check made to resist being tripped.				
Staff of Discipline		PROFICIENCY:WEAPON|Quarterstaff	TYPE:Weapon.Melee.TwoHanded.Simple.Double.Standard.Bludgeoning.Quarterstaff.Monk	COST:0	WT:4	WIELD:TwoHanded		SIZE:M	DAMAGE:1d6	CRITRANGE:1	CRITMULT:x2	EQMOD:WOOD.MWORKW.PLUS2W.LAW_M			ALTTYPE:Enhancement.Weapon.Melee.Bludgeoning	ALTDAMAGE:1d6	ALTCRITRANGE:1	ALTCRITMULT:x2	ALTEQMOD:WOOD.MWORKW.PLUS2W.LAW_M	SOURCEPAGE:AaEG	MODS:NO	SPROP:can use better Monk unharmed attack rate.|PRECLASS:1,Monk=1				
Staff of Memory		PROFICIENCY:WEAPON|Quarterstaff	TYPE:Weapon.Melee.TwoHanded.Simple.Double.Standard.Bludgeoning.Quarterstaff	COST:0	WT:4	WIELD:TwoHanded		SIZE:M	DAMAGE:1d6	CRITRANGE:1	CRITMULT:x2	EQMOD:WOOD.MWORKW.PLUS1W			ALTTYPE:Enhancement.Weapon.Melee.Bludgeoning	ALTDAMAGE:1d6	ALTCRITRANGE:1	ALTCRITMULT:x2	ALTEQMOD:WOOD.MWORKW.PLUS1W	SOURCEPAGE:AaEG	MODS:NO	SPROP:1/day can lose a prepared spell to recall a lower level spell.				
Standard of Ulek		PROFICIENCY:WEAPON|Waraxe (Dwarven)	TYPE:Enhancement.Weapon.Melee.Martial.Exotic.Specific.Dwarven.Slashing.Axe	COST:30	WT:8	WIELD:TwoHanded		SIZE:M	DAMAGE:1d10	CRITRANGE:1	CRITMULT:x3	EQMOD:MITHRAL_ITEM.MWORKW.PLUS2W								SOURCEPAGE:AaEG	MODS:NO	SPROP:Dwarves allied with the wielder in 10-ft radius gain +1 morale bonus on attack rolls.	BONUS:WEAPON|WIELDCATEGORY|-1|PREFEAT:1,Exotic Weapon Proficiency (Waraxe (Dwarven))			
Stone Spear		PROFICIENCY:WEAPON|Shortspear	TYPE:Enhancement.Weapon.Melee.Ranged.Thrown.Simple.Specific.Piercing.Spear	COST:1	WT:10	WIELD:OneHanded		SIZE:M	DAMAGE:1d6	CRITRANGE:1	CRITMULT:x3	EQMOD:STONE.MWORKW.PLUS2W		RANGE:10						SOURCEPAGE:AaEG	MODS:NO	SPROP:double damage against creature with Air subtype. Triple damage when set against charging opponent.				
Sword of Avoidance		PROFICIENCY:WEAPON|Longsword	TYPE:Enhancement.Weapon.Melee.Martial.Specific.Slashing.Sword	COST:15	WT:4	WIELD:OneHanded		SIZE:M	DAMAGE:1d8	CRITRANGE:2	CRITMULT:x2	EQMOD:STEEL.MWORKW.PLUS3W								SOURCEPAGE:AaEG	MODS:NO	SPROP:+4 luck bonus on AC and all saving throws when Total Defense				
Sword of Countering		PROFICIENCY:WEAPON|Longsword	TYPE:Enhancement.Weapon.Melee.Martial.Specific.Slashing.Sword	COST:15	WT:4	WIELD:OneHanded		SIZE:M	DAMAGE:1d8	CRITRANGE:2	CRITMULT:x2	EQMOD:STEEL.MWORKW.PLUS1W								SOURCEPAGE:AaEG	MODS:NO	SPROP:3/day Dispel Magic (13 level caster) to counterspell.				
Sword of Crypts		PROFICIENCY:WEAPON|Longsword	TYPE:Enhancement.Weapon.Melee.Martial.Specific.Slashing.Sword	COST:15	WT:4	WIELD:OneHanded		SIZE:M	DAMAGE:1d8	CRITRANGE:2	CRITMULT:x2	EQMOD:STEEL.MWORKW.PLUS2W.HOLY_M								SOURCEPAGE:AaEG	MODS:NO		BONUS:VAR|TurnTimesUndead|1	BONUS:VAR|TurnDamagePlusUndead|2|TYPE=Enhancement|PREMULT:2,[PRECLASS:1,CLERIC=1],[PREDEITY:1,Heironeus]		
Sword of the Diplomat		PROFICIENCY:WEAPON|Sword (Short)	TYPE:Enhancement.Weapon.Melee.Finesseable.Martial.Specific.Piercing.Sword	COST:10	WT:2	WIELD:Light		SIZE:M	DAMAGE:1d6	CRITRANGE:2	CRITMULT:x2	EQMOD:STEEL.MWORKW.PLUS3W.DEFEND								SOURCEPAGE:AaEG	MODS:NO		BONUS:COMBAT|AC|4|TYPE=Armor			
Sword of Escape		PROFICIENCY:WEAPON|Sword (Short)	TYPE:Enhancement.Weapon.Melee.Finesseable.Martial.Specific.Piercing.Sword	COST:10	WT:2	WIELD:Light		SIZE:M	DAMAGE:1d6	CRITRANGE:2	CRITMULT:x2	EQMOD:STEEL.MWORKW.PLUS2W								SOURCEPAGE:AaEG	MODS:NO	SPROP:can be used during a grapple even if not tiny.	ABILITY:Special Ability|VIRTUAL|Domain ~ Travel			
Sword of Graceful Strikes		PROFICIENCY:WEAPON|Sword (Short)	TYPE:Enhancement.Weapon.Melee.Finesseable.Martial.Specific.Piercing.Sword	COST:10	WT:2	WIELD:Light		SIZE:M	DAMAGE:1d6	CRITRANGE:2	CRITMULT:x2	EQMOD:STEEL.MWORKW.PLUS3W								SOURCEPAGE:AaEG	MODS:NO		BONUS:WEAPON|DAMAGE|(DEX-STR)			
Sword of Judgment		PROFICIENCY:WEAPON|Longsword	TYPE:Enhancement.Weapon.Melee.Martial.Specific.Slashing.Sword	COST:15	WT:4	WIELD:OneHanded		SIZE:M	DAMAGE:1d8	CRITRANGE:2	CRITMULT:x2	EQMOD:STEEL.MWORKW.PLUS2W.LAW_M								SOURCEPAGE:AaEG	MODS:NO		SPELLS:Sword of Judgment|TIMES=3|CASTERLEVEL=113|Zone of Truth,13			
Sword of the Mammoth		PROFICIENCY:WEAPON|Greatsword	TYPE:Enhancement.Weapon.Melee.Martial.Specific.Slashing.Sword	COST:50	WT:8	WIELD:TwoHanded		SIZE:M	DAMAGE:2d6	CRITRANGE:2	CRITMULT:x2	EQMOD:STEEL.MWORKW.PLUS2W								SOURCEPAGE:AaEG	MODS:NO		BONUS:HP|CURRENTMAX|6			
Sword of Opportunity		PROFICIENCY:WEAPON|Longsword	TYPE:Enhancement.Weapon.Melee.Martial.Specific.Slashing.Sword	COST:15	WT:4	WIELD:OneHanded		SIZE:M	DAMAGE:1d8	CRITRANGE:2	CRITMULT:x2	EQMOD:STEEL.MWORKW.PLUS2W								SOURCEPAGE:AaEG	MODS:NO	SPROP:you may make an additional attack of opportunity per round.				
Sword of Readyness		PROFICIENCY:WEAPON|Sword (Two-Bladed)	TYPE:Enhancement.Weapon.Melee.Exotic.Double.Specific.Slashing.Sword	COST:100	WT:10	WIELD:TwoHanded	SLOTS:2	SIZE:M	DAMAGE:1d8	CRITRANGE:2	CRITMULT:x2	EQMOD:STEEL.MWORKW.PLUS2W				ALTDAMAGE:1d8	ALTCRITRANGE:1	ALTCRITMULT:x2	ALTEQMOD:STEEL.MWORKW.PLUS2W	SOURCEPAGE:AaEG	MODS:NO	SPROP:you can prepare a full attack action with this weapon.				
Sword of Retribution		PROFICIENCY:WEAPON|Sword (Bastard)	TYPE:Enhancement.Weapon.Melee.Martial.Exotic.Specific.Slashing.Sword	COST:70	WT:12	WIELD:TwoHanded		SIZE:M	DAMAGE:1d10	CRITRANGE:2	CRITMULT:x2	EQMOD:STEEL.MWORKW.PLUS3W								SOURCEPAGE:AaEG	MODS:NO	SPROP:after being wounded gain +2 morale bonus on attack and damage rolls on next attack against who damaged him.	BONUS:WEAPON|WIELDCATEGORY|-1|PREFEAT:1,Exotic Weapon Proficiency (Sword (Bastard))			
Sword of Sanctuary		PROFICIENCY:WEAPON|Longsword	TYPE:Enhancement.Weapon.Melee.Martial.Specific.Slashing.Sword	COST:15	WT:4	WIELD:OneHanded		SIZE:M	DAMAGE:1d8	CRITRANGE:2	CRITMULT:x2	EQMOD:STEEL.MWORKW.PLUS2W								SOURCEPAGE:AaEG	MODS:NO		SPELLS:Sword of Sanctuary|TIMES=1|CASTERLEVEL=5|Sanctuary,14|Obscuring Mist			
Sword of the Solars		PROFICIENCY:WEAPON|Sword (Bastard)	TYPE:Enhancement.Weapon.Melee.Martial.Exotic.Specific.Slashing.Sword	COST:140	WT:24	WIELD:TwoHanded		SIZE:L	DAMAGE:2d6	CRITRANGE:2	CRITMULT:x2	EQMOD:STEEL.MWORKW.PLUS5W.DANCE.VORPAL.LGHT_EMIT								SOURCEPAGE:AaEG	MODS:NO		BONUS:WEAPON|WIELDCATEGORY|-1|PREFEAT:1,Exotic Weapon Proficiency (Sword (Bastard))			
Sword of Versatility		PROFICIENCY:WEAPON|Sword (Two-Bladed)	TYPE:Enhancement.Weapon.Melee.Exotic.Double.Specific.Slashing.Sword	COST:100	WT:10	WIELD:TwoHanded	SLOTS:2	SIZE:M	DAMAGE:1d8	CRITRANGE:2	CRITMULT:x2	EQMOD:STEEL.MWORKW.PLUS2W				ALTDAMAGE:1d8	ALTCRITRANGE:1	ALTCRITMULT:x2	ALTEQMOD:STEEL.MWORKW.PLUS2W	SOURCEPAGE:AaEG	MODS:NO	SPROP:can be transformed into two +1 longsword with a move-equivalent action and vice-versa.				
Sword of Zeal		PROFICIENCY:WEAPON|Sword (Bastard)	TYPE:Enhancement.Weapon.Melee.Martial.Exotic.Specific.Slashing.Sword	COST:70	WT:12	WIELD:TwoHanded		SIZE:M	DAMAGE:1d10	CRITRANGE:2	CRITMULT:x2	EQMOD:STEEL.MWORKW.PLUS2W.HOLY_M								SOURCEPAGE:AaEG	MODS:NO	SPROP:ignore damage reduction of outsiders.	BONUS:WEAPON|WIELDCATEGORY|-1|PREFEAT:1,Exotic Weapon Proficiency (Sword (Bastard))	SPROP:channel lay on hand to increse damage against evil outsiders and undead.|PRECLASS:1,Paladin=1		
Tourney Lance		PROFICIENCY:WEAPON|Lance	TYPE:Enhancement.Weapon.Melee.Martial.Reach.Specific.Piercing.Lance	COST:10	WT:10	WIELD:TwoHanded		SIZE:M	DAMAGE:1d8	CRITRANGE:1	CRITMULT:x3	EQMOD:WOOD.MWORKW.PLUS2W.LAW_M	REACHMULT:2							SOURCEPAGE:AaEG	MODS:NO	SPROP:ignore penalty for inflicting non lethal damage.				
Trident of the Depths		PROFICIENCY:WEAPON|Trident	TYPE:Enhancement.Weapon.Melee.Martial.Ranged.Thrown.Specific.Piercing.Trident	COST:15	WT:4	WIELD:OneHanded		SIZE:M	DAMAGE:1d8	CRITRANGE:1	CRITMULT:x2	EQMOD:STEEL.MWORKW.PLUS1W		RANGE:10						SOURCEPAGE:AaEG	MODS:NO	SPROP:Swim, 30 ft. +1 additional attack and damage bonus when submerged in water +2 when submerged into ocean.				
Truestone Hammer		PROFICIENCY:WEAPON|Hammer (Gnome Hooked)	TYPE:Enhancement.Weapon.Melee.Exotic.Double.specific.Gnome.Bludgeoning.Hammer	COST:20	WT:6	WIELD:TwoHanded	SLOTS:2	SIZE:M	DAMAGE:1d8	CRITRANGE:1	CRITMULT:x2	EQMOD:STEEL.MWORKW.PLUS2W			ALTTYPE:Enhancement.Weapon.Melee.Exotic.Piercing	ALTDAMAGE:1d6	ALTCRITRANGE:1	ALTCRITMULT:x4	ALTEQMOD:STEEL.MWORKW.PLUS1W	SOURCEPAGE:AaEG	MODS:NO	SPROP:3/day Dispel Magic (15 level caster) against an illusion.	SPELLS:Truestone Hammer|TIMES=1|CASTERLEVEL=15|Stone Shape			
Twin Blade		PROFICIENCY:WEAPON|Guisarme	TYPE:Enhancement.Weapon.Melee.Martial.Reach.Specific.Slashing.Polearm	COST:9	WT:12	WIELD:TwoHanded		SIZE:M	DAMAGE:2d4	CRITRANGE:1	CRITMULT:x3	EQMOD:STEEL.MWORKW.PLUS3W	REACHMULT:2							SOURCEPAGE:AaEG	MODS:NO		SPELLS:Twin Blade|TIMES=2|CASTERLEVEL=8|Spiritual Weapon			
Vanishing Blade		PROFICIENCY:WEAPON|Rapier	TYPE:Enhancement.Weapon.Melee.Martial.Finesseable.Standard.Piercing.Sword	COST:20	WT:2	WIELD:OneHanded		SIZE:M	DAMAGE:1d6	CRITRANGE:3	CRITMULT:x2	EQMOD:STEEL.MWORKW.PLUS3W								SOURCEPAGE:AaEG	MODS:NO	SPROP:1/day Dimensional Door after hitting a target.	BONUS:WEAPON|DAMAGEMULT:2|-0.5			
Vigilant Halberd		PROFICIENCY:WEAPON|Halberd	TYPE:Enhancement.Weapon.Melee.Martial.Specific.Piercing.Slashing.Polearm	COST:10	WT:12	WIELD:TwoHanded		SIZE:M	DAMAGE:1d10	CRITRANGE:1	CRITMULT:x3	EQMOD:STEEL.MWORKW.PLUS4W.DEFEND								SOURCEPAGE:AaEG	MODS:NO	SPROP:the smite evil ability deals 2 points of damage per level instead of 1.|PRECLASS:1,Paladin=1				
Viper Whip		PROFICIENCY:WEAPON|Whip	TYPE:Enhancement.Weapon.Melee.Exotic.Reach.Finesseable.Specific.Subdual.Slashing	COST:1	WT:2	WIELD:OneHanded		SIZE:M	DAMAGE:1d3	CRITRANGE:1	CRITMULT:x2	EQMOD:LEATHER.MWORKW.PLUS2W	REACH:15							SOURCEPAGE:AaEG	MODS:NO	SPROP:10 rnd/day Poison Injury DC 11, Init.:1d6 CON, Sec.:1d6 CON.				
Warrenguard		PROFICIENCY:WEAPON|Sword (Short)	TYPE:Enhancement.Weapon.Melee.Finesseable.Martial.Specific.Piercing.Sword	COST:10	WT:2	WIELD:Light		SIZE:M	DAMAGE:1d6	CRITRANGE:2	CRITMULT:x2	EQMOD:STEEL.MWORKW.PLUS2W								SOURCEPAGE:AaEG	MODS:NO					
Weaponeater		PROFICIENCY:WEAPON|Club	TYPE:Enhancement.Weapon.Melee.Ranged.Thrown.Simple.Specific.Bludgeoning.Club	COST:0	WT:3	WIELD:OneHanded		SIZE:M	DAMAGE:1d6	CRITRANGE:1	CRITMULT:x2	EQMOD:WOOD.MWORKW.PLUS3W.CHARGED_ITEM_50|50		RANGE:10						SOURCEPAGE:AaEG	MODS:NO	SPROP:Rust attacked weapon. Fort DC 16.				
Whirling Axe		PROFICIENCY:WEAPON|Greataxe	TYPE:Enhancement.Weapon.Melee.Martial.Specific.Slashing.Axe	COST:20	WT:12	WIELD:TwoHanded		SIZE:M	DAMAGE:1d12	CRITRANGE:1	CRITMULT:x3	EQMOD:STEEL.MWORKW.PLUS2W								SOURCEPAGE:AaEG	MODS:NO	SPROP:1/day Whirlwind Attack.				
Whisperblade		PROFICIENCY:WEAPON|Greataxe	TYPE:Enhancement.Weapon.Melee.Martial.Specific.Slashing.Axe	COST:20	WT:12	WIELD:TwoHanded		SIZE:M	DAMAGE:1d12	CRITRANGE:1	CRITMULT:x3	EQMOD:STEEL.MWORKW.PLUS4W								SOURCEPAGE:AaEG	MODS:NO	SPROP:3/day Silent attack cause Silence on target (casterlevel 5, Fort DC 15)				
