SOURCELONG:Forgotten Realm Campaing setting	SOURCESHORT:FRCS		SOURCEWEB:http://www.gozzilioni.net
		
#Teleport	CLASSES:Sorcerer,Wizard=5	TYPE:Arcane.Divine
#Change Self.MOD	CLASSES:Harper Scout=1
Disguise Self.MOD	CLASSES:Harper Scout=1
Charm Person.MOD	CLASSES:Harper Scout=1
Comprehend Languages.MOD	CLASSES:Harper Scout=1	
Erase.MOD	CLASSES:Harper Scout=1
Feather Fall.MOD	CLASSES:Harper Scout=1
Jump.MOD	CLASSES:Harper Scout=1
Light.MOD	CLASSES:Harper Scout=1
Message.MOD	CLASSES:Harper Scout=1
Mount.MOD	CLASSES:Harper Scout=1
Read Magic.MOD	CLASSES:Harper Scout=1	
Scatterspray.MOD	CLASSES:Harper Scout=1	
Sleep.MOD	CLASSES:Harper Scout=1
Spider Climb.MOD	CLASSES:Harper Scout=1
Cat's Grace.MOD	CLASSES:Harper Scout=2
Darkvision.MOD	CLASSES:Harper Scout=2
Detect Thoughts.MOD	CLASSES:Harper Scout=2
Eagle's Splendor.MOD	CLASSES:Harper Scout=2
Invisibility.MOD	CLASSES:Harper Scout=2
Knock.MOD	CLASSES:Harper Scout=2
Locate Object.MOD	CLASSES:Harper Scout=2
Magic Mouth.MOD	CLASSES:Harper Scout=2
Misdirection.MOD	CLASSES:Harper Scout=2
See Invisibility.MOD	CLASSES:Harper Scout=2
Shadow Mask.MOD	CLASSES:Harper Scout=2
Claiaudience/Clairvoyance.MOD	CLASSES:Harper Scout=3
Nondetection.MOD	CLASSES:Harper Scout=3
Suggestion.MOD	CLASSES:Harper Scout=3
Tongues.MOD	CLASSES:Blackguard=3	
Undetectable Alignment.MOD	CLASSES:Harper Scout=3
